Phage Name	Cluster
244	E
Aangyi	Unclustered
AardvarkArthur	Unclustered
Aasha	Unclustered
Abakes	Unclustered
Abaris	Unclustered
AbbyNormal	None
ABC123	Unclustered
ABCat	E
Abdiel	A4
Abe1	Unclustered
Abed	Unclustered
Abena	Unclustered
Abilicious4	G
Aboli	Unclustered
Abre	Unclustered
Abrogate	A1
Abstergo1007	G
ABU	B1
Abu1	Unclustered
Acadian	B5
Ace11	Unclustered
Acephal	Unclustered
Acer	Unclustered
Achebe	A4
ACheetah	Unclustered
Achilles	Unclustered
Achilles13	Unclustered
Achmed	Unclustered
ActionBDixon	Unclustered
Adam	Unclustered
Adawi	B4
Addy	Unclustered
Adephagia	K1
AdiaLP	Unclustered
Adjutor	D1
Adnama	Unclustered
Adrian	Unclustered
Adriano919	Unclustered
Adrienne	Unclustered
Aduonum	Unclustered
Adva	Unclustered
Adwa	Unclustered
Adzzy	A2
Aeger	Unclustered
Aegis0001	Unclustered
Aeneas	A1
Affiong	Unclustered
AFIS	A1
AFreeWelcome	Unclustered
AfternoonDlite	Unclustered
Aftershock	Unclustered
Afua	None
Agape74	A2
AgentM	A5
AgentP	Unclustered
Agkelos	Unclustered
Aglet	A3
Agumnasia	Unclustered
Aguona	Unclustered
Agwe	Unclustered
Ahawk10	Unclustered
Ahlen	Unclustered
Ahleritis	Unclustered
Ahndy	Unclustered
Ahosey	Unclustered
Airmid	A5
AJ1010	Unclustered
Ajamka	Unclustered
Ajaxious	None
AJWSabo	Unclustered
Ak907	Unclustered
Akamu	Unclustered
AkanSemIII	Unclustered
Akari	Unclustered
AkinShadow	Unclustered
Akoma	B3
Akroma	Unclustered
Akusoba	Unclustered
Aladeen	Unclustered
ALaeddis	Unclustered
Alan	Unclustered
AlanGrant	B4
AlanP	Unclustered
Alaric	Unclustered
Albee	Unclustered
Albertella	Unclustered
Alberto	Unclustered
Alberto1	Unclustered
Alberto11	A1
Albie	Unclustered
Albrecht	Unclustered
AlbusD	Unclustered
Alcor	Unclustered
AldoRaine	Unclustered
Alegria	Unclustered
Alejandro	Unclustered
Alex	B1
Alexander	Unclustered
Alfieman	Unclustered
Alice	C1
AliceSaturn	Unclustered
Alicia	Unclustered
Alina	Unclustered
Alis	None
Allen	Unclustered
AllenRay	Unclustered
AllieCat	Unclustered
Alloment	Unclustered
Alma	A9
Almona	Unclustered
Aloaparom	Unclustered
Aloysius	None
Alpaca	Unclustered
Alpha	Unclustered
AlphaEpsilon	Unclustered
Alphalfa	Unclustered
AlphaPhelix	Unclustered
Alphie	Unclustered
AlphieLion	Unclustered
Alphyn	Unclustered
Alpine 	Unclustered
Alpine7	Unclustered
Alsfro	A1
Altair	Unclustered
Alterdim	Unclustered
Altwerkus	B1
Alvin	A1
Alyahs	Unclustered
Amaziah	Unclustered
Ambecsalie	Unclustered
Ambi	Unclustered
Ambition	Unclustered
Amed001	Unclustered
Amelie	K1
Amicitia	Unclustered
Amiratis	Unclustered
Amiscus	Unclustered
Amita	Unclustered
AmKeeZ	Unclustered
Ammit	Unclustered
Amoney	Unclustered
Amontillado	I1
Amore7	Unclustered
Amphi	Unclustered
Anaklusmus	Unclustered
Anarchy	Unclustered
AnasLacus	Unclustered
Anastaciya11	Singleton
Anathema	Unclustered
Anaxagorus	F1
Anaximander	Unclustered
Anaya	K1
Andalicia	Unclustered
Andon31	Unclustered
Andranna	Unclustered
Andreas	Unclustered
Andromeda	Unclustered
AndyDandy	Unclustered
AngeDeLaMort	Unclustered
Angel	G
Angelica	K1
Angelito	Unclustered
AngelPhace	Unclustered
AngelSong	Unclustered
Angelwings	Unclustered
Angercorn	Unclustered
Anghus	Unclustered
Anglerfish	A1
Angus	Unclustered
Anina	Unclustered
Anitus	Unclustered
Anna	Unclustered
Annabelle	Unclustered
AnnaL29	A2
Annathu	Unclustered
Annibelle	Unclustered
Annie	Unclustered
AnnieAbelard	Unclustered
Annihilator	G
Anonymous	Unclustered
Ansem	Unclustered
Ant1Dodson	F1
Antal	Unclustered
Anthouse18	Unclustered
Anthyrobi	Unclustered
Antiswag	Unclustered
Antonesca	Unclustered
Anubis	A3
AnulusNox	Unclustered
Ap0103	Unclustered
AP5Beta	Unclustered
APE308	B1
Apetito	Unclustered
Apizium	B1
Aplaquealypse	Unclustered
Apocalypse	K1
Apokalupsis	E
Apollo	Unclustered
Appletree2	L1
Aqua	Unclustered
Aquarose	A2
Aragog	A5
Araneam	Unclustered
Arayna	Unclustered
Arbiter	B2
Arbol	Unclustered
Arcanine	A1
ArcherNM	None
ArcherS7	C1
Archetta	A5
Archie	L2
Arcie	Unclustered
Arcturus	Unclustered
Ardmore	F1
Areg16	Unclustered
Ares	B2
AreToDeeTo	Unclustered
Argel7	Unclustered
Argh	Unclustered
Argo	Unclustered
Ariel	J
Arielle	Unclustered
Arienne	F1
ArigunDD10	Unclustered
ArigunHALO	Unclustered
ArigunLND	Unclustered
Arizona	Unclustered
Arminius	Unclustered
Arnold	Unclustered
Aro9312	Unclustered
Arroz	Unclustered
Artemis	Unclustered
Artemis2UCLA	A6
Arthur	Unclustered
ArtieJr	Unclustered
Arturo	A4
Aruba	Unclustered
AsaBoo	Unclustered
Asayake	None
Asclepius	Unclustered
AsepTech	A2
Asert12	Unclustered
Ash1	Unclustered
Asha	Unclustered
Ashleigh	Unclustered
AsianInvasion	Unclustered
Aspire	Unclustered
Assassinator	A3
Astaroth	Unclustered
Astraea	C1
Astro	A8
Astro141	Unclustered
AstrumP28	B1
Asuzu	A2
Athena	B3
Athos	Unclustered
Atkinbua	A1
Atlantis	Unclustered
Atlas	C1
Atlas13	Unclustered
AtLast	Unclustered
Atomi	Unclustered
Atticus	Unclustered
AtticusBane	Unclustered
AubreyG	Unclustered
Audrey	B3
Audrizzle82	Unclustered
AugustRush	Unclustered
Augustus	Unclustered
AuLait	Unclustered
Auralea	Unclustered
Auran	Unclustered
Aurelius	Unclustered
Aureole	Unclustered
Aurora	Unclustered
Austrolorp	E
Autumn	Unclustered
Ava3	C1
Avani	F2
Avatar	Unclustered
AvatarAhPeg	A4
Avenger	Unclustered
AverageJoe	Unclustered
Avett	Unclustered
Avrafan	G
Avril	Unclustered
Awan	Unclustered
Awkward	Unclustered
AwkwardPenguin	Unclustered
Axel	Unclustered
Ayana	Unclustered
Ayashe	Unclustered
AyJay1824	B1
AYYpapi	Unclustered
Azarath	None
Azenavy	Unclustered
Azeus1	None
Azurill	Unclustered
B2max	Unclustered
Babette	Unclustered
BaboJay	Unclustered
Babsiella	I1
Baby16	A4
BabyBoo	Unclustered
BabyHowie	Unclustered
BabyP	Unclustered
BabyRay	A3
BabyTiger	Unclustered
BabyWaffle	Unclustered
Bacaria	Unclustered
Bacatac	Unclustered
BacAttack	Unclustered
Bacchus	Unclustered
Bachome	A11
Backyard	Unclustered
Backyardigan	A4
Bacon	A4
Bactina	Unclustered
Bactobuster	A2
Bacx	Unclustered
BadAgartude	Unclustered
Badboyz	Unclustered
Badfish	B1
Badger	A4
BadWolf	Unclustered
Baee	B5
Baelfire	Unclustered
Baeniqua	Unclustered
Bafana	Unclustered
Baftija0801	Unclustered
Bagasao	Unclustered
Bagel	Unclustered
BahamaJoe	Unclustered
Bailan	Unclustered
BaileyIII	Unclustered
Bails	Unclustered
BAKA	J
Balakay	Unclustered
Balder	Unclustered
Baller12	Unclustered
Ballerina	Unclustered
Balloon	Unclustered
BALunt2009	Unclustered
BamBam	Unclustered
Bambi	Unclustered
Bamboo	Unclustered
Bamboozle	Unclustered
Bammy	Unclustered
Banana	Unclustered
Bananas2	Unclustered
Bananigans	Unclustered
Bandgeek	Unclustered
Bandit	Unclustered
Bandsmeg13	Unclustered
Bane	Unclustered
Bane1	B4
Bane2	B4
Bangla1971	C1
Banjo	B1
Banshee	Unclustered
Bao85	Unclustered
Barbara	Unclustered
Barberry	Unclustered
Barca	Unclustered
Barnabas	Unclustered
Barnacleboy	Unclustered
Barney	Unclustered
Barnyard	H2
BarrelRoll	K1
Barriga	A1
BarryO	Unclustered
Bart	Unclustered
Bartholomew	P
Bartley	Unclustered
Bartonat	Unclustered
Basedgod	Unclustered
Basic	Unclustered
BasicB	Unclustered
Basil	Unclustered
Basilax	Unclustered
Bask21	E
BassSlayer	Unclustered
Bathsheba	Unclustered
Batiatus	F1
BatJane	Unclustered
BatteryCK	B1
Battman	Unclustered
Baxter	Unclustered
BaxterTD	None
Bazinga	Unclustered
BDavies	Unclustered
Bdboytothird89	Unclustered
BDiaz	Unclustered
Beanal19	Unclustered
Beanpole	Unclustered
BeansNcheese85	Unclustered
Beansprout	Unclustered
BeanWater	C1
Bear	Unclustered
Bear06	Unclustered
Beast	Unclustered
Beastly	Unclustered
Beau	Unclustered
Beautiphul	Unclustered
Beaux	Unclustered
Bebe	Unclustered
Becaw11	A4
Becca	Unclustered
Beckett	Unclustered
Bectonian	Unclustered
BeeBeeKayElle	Unclustered
BeeBop	Unclustered
Beefington	Unclustered
Beep	Unclustered
BeeQQ	Unclustered
BeesKnees	A1
BEEST	K1
Behar	Unclustered
Behemoth	Unclustered
Belenaria	Unclustered
Bella	Unclustered
Bella08	Unclustered
Bella10	Unclustered
Bella4494	Unclustered
Bella96	K1
Bellatrix	Unclustered
BellaWella	Unclustered
Belle	Unclustered
BellusTerra	A4
Belv	Unclustered
Bender	Unclustered
Bendy	Unclustered
Benedict	A5
Benedict11	Unclustered
BengaliBalla92	B1
Benji3	Unclustered
Bentley	Unclustered
Beowulf	Unclustered
Bernal13	T
Bernard	Unclustered
BernardChase24	Unclustered
Bernardo	B3
Bernice	Unclustered
Bernicus	Unclustered
Berns	Unclustered
Bert1	Unclustered
Berta	Unclustered
Bertha	Unclustered
Bestly69	Unclustered
BestPHever	Unclustered
Betelgeuse	Unclustered
Beth10	Unclustered
Bethlehem	A1
BetsyGirl	Unclustered
Betty	Unclustered
Beyonce	Unclustered
Bfree1	Unclustered
Bhonjo	Unclustered
Biaggio	D1
Biblo	Unclustered
Bico22	Unclustered
Biebs	Unclustered
Big20	Unclustered
BigAL	Unclustered
BigBen	Unclustered
BigBertha	Unclustered
BigBill	Unclustered
BigBird	Unclustered
Bigfoot	Unclustered
Biggie	Unclustered
BiggieSmalls	Unclustered
BigHalo2	Unclustered
BigMama	D1
BigMamaLlama	A1
BigMau	None
BigNuz	P
BigP	Unclustered
BigPain	Unclustered
BigPapa	Unclustered
BigPhil	F1
BigPoppa	Unclustered
BigRedd	Unclustered
BigRon11	Unclustered
BigSky	Unclustered
Bigswole	C1
BigYeez	Unclustered
Biko	Unclustered
Bilahkay	Unclustered
Bilbo	Unclustered
Bill	Unclustered
Billiken	Unclustered
BillKnuckles	A1
BillyGoat	Unclustered
BillyJ	Unclustered
BillyP	Unclustered
Binebulous	Unclustered
Bingdu	Unclustered
Bingo	Unclustered
Bink	Unclustered
Biotre3	Unclustered
Bipolar	F1
Bipper	Unclustered
Bir14	Unclustered
Birthsperate	Unclustered
Biryani	Unclustered
Biscuits	Unclustered
Bish	Unclustered
Bison	A1
Bitsy	Unclustered
BIvory	Unclustered
BlackburnSoil	Unclustered
BlackEyedSusan	Unclustered
BlackGarnet	Unclustered
BlackHawk	Unclustered
Blackjugernaut	Unclustered
BlackMagic	Unclustered
Blacknight	Unclustered
BlackOps	Unclustered
BlackPlague	Unclustered
BlackStallion	B1
Blackthunder	Unclustered
Blackwing	Unclustered
Blagers	Unclustered
Blammo	Unclustered
BlancoPata	Unclustered
Bland	Unclustered
BlaqueIvy	None
Blargy	Unclustered
Blastoise	Unclustered
Blaze	Unclustered
Blazer	None
Blevins	Unclustered
Blink	Unclustered
Blinky	Unclustered
Blister	Unclustered
Blitz	Unclustered
Blitzen	Unclustered
Blitzkrieg	A10
Blizzard	Unclustered
BlkCherry	Unclustered
Blonski	Unclustered
Bloo	Unclustered
Blopp	Unclustered
Blossom	Unclustered
Blowpop	Unclustered
Blue7	A6
BlueHead	Unclustered
BlueMannequin	Unclustered
BlueMountain	Unclustered
BlueSky	K1
BlueSteel	Unclustered
Bluntus	Unclustered
Bluster	L2
Bmamba1	Unclustered
BMsquared	Unclustered
BOAA	Unclustered
Boatsnbros	Unclustered
Bob1	Unclustered
Bob2	Unclustered
Bob3	A1
Bobbinson	Unclustered
BobbyPin	Unclustered
Bobert	Unclustered
Bobi	F1
BobJr	Unclustered
Bobo	Unclustered
BobSquared	Unclustered
Bobsrjrthe3	Unclustered
Bocefus	Unclustered
Bocephus	Unclustered
Boco	Unclustered
Boe26	Unclustered
BoHanna	Unclustered
BoiC	Unclustered
Boiiii	Unclustered
BoJackson	Unclustered
BoldKnight	Unclustered
Bolt	Unclustered
Bombola	Unclustered
Bond	Unclustered
Bonesquad	Unclustered
Bongo	M1
Bonnie	Unclustered
Bonnie2013	Unclustered
BonQuiQui	Unclustered
BontFonne	K2
Bonuspoints	Unclustered
Boogeyman	Unclustered
Boogie	Unclustered
BookWyrm	Unclustered
Boombay	Unclustered
Boomer	F1
Boomerang	Unclustered
Boon	Unclustered
BOOYA	Unclustered
Bop	Unclustered
Borealis	Unclustered
Borge	Unclustered
BoryCriar	Unclustered
Boshaft	Unclustered
BoSox	Unclustered
Boss7	Unclustered
BossMaster	Unclustered
Bowie	Unclustered
Boyd	Unclustered
Boyer	Unclustered
Boyfriend	Unclustered
BPBiebs31	A1
BPs	G
BQuat	G
Braemar	F1
Brandon	Unclustered
Brandy	Unclustered
Branton	Unclustered
Bras	Unclustered
Brazos	Unclustered
Breeniome	C1
Breeze	Unclustered
Breezona	L2
Brenda	Unclustered
Brenise	Unclustered
Brenna	Unclustered
Brent03	Unclustered
Brian	Unclustered
BriannaTaliah	Unclustered
BrianSwimBoy	Unclustered
Brick1017	Unclustered
Bricole	M1
Bridge	Unclustered
Briellie	Unclustered
BrightIdea	Unclustered
Brightside	Unclustered
Brink	Unclustered
Bristles	Unclustered
Britney	Unclustered
Brittany	Unclustered
Brocalys	F1
BRod943	B1
Brody	A1
Brodysseus	Unclustered
Broe	Unclustered
BroFist	Unclustered
BronBron6	Unclustered
Bronco	Unclustered
Brooke	Unclustered
Brooklyn	None
Broseidon	A4
Broseph	Unclustered
Brown4469	Unclustered
Browncna	B4
Brownie	Unclustered
Bruce	Unclustered
Bruce1	Unclustered
Bruce2	Unclustered
Bruce3	Unclustered
BruceB	G
Bruin	E
Bruiser	A4
Brujita	I1
Bruno	Unclustered
Bruns	A1
Brusacoram	P
Brutar	Unclustered
Brutus	Unclustered
Bruvh	Unclustered
Bryanna	Unclustered
Bryce	Unclustered
Bryler	Unclustered
BTBethanie	Unclustered
BTBrendan	Unclustered
Bubba	Unclustered
Bubba1	Unclustered
Bubbajay	A4
Bubble	Unclustered
Bubbles	Unclustered
Bubbles123	F1
BubblesPP	Unclustered
BubbleTrouble	A4
BubbleWrap	Unclustered
BubthatCould	Unclustered
Bubuh	Unclustered
Buckbeak	Unclustered
Buckeye	B1
BuckeyeNut	Unclustered
Bucky	Unclustered
Buddha	Unclustered
Buddies	Unclustered
Buddy	A2
Buddy123	Unclustered
BuddyII	Unclustered
Bueller	Unclustered
Buffy	Unclustered
Buffy1	Unclustered
BugABoo27	Unclustered
Buggy	Unclustered
BugSlayer	Unclustered
Bugsy	A2
Buhle	Unclustered
Buisson	J
Buks93	Unclustered
Bulldog	A2
Bullet	Unclustered
BulletM	Unclustered
Bulletproof	Unclustered
BullMach3	Unclustered
BullsEye	B1
Bullseyed	A1
BullseyeJones	Unclustered
Bullzii10	Unclustered
Bumblebee	Unclustered
Bumblebee2	Unclustered
BumInTheAttic	Unclustered
Bunchy	Unclustered
BunkerPH	Unclustered
Bunnies	P
Burbuja	Unclustered
Burger	A4
Burke	Unclustered
Burnface	Unclustered
Burns	Unclustered
Burrito	Unclustered
Burt	Unclustered
Burton	Unclustered
Busi	Unclustered
Busta	Unclustered
Buster	Unclustered
BusterBird12	Unclustered
BustinJunch	Unclustered
Buter	Unclustered
Butterball8	Unclustered
Buttercup	Unclustered
Butterfly	Unclustered
Butters	N
Butters12k	Unclustered
Butterscotch	D1
Buwch	Unclustered
BuzzKiehl	None
BuzzLyseyear	F1
Buzzy	Unclustered
Bwall15	Unclustered
BWBransam	Unclustered
Bwunder	Unclustered
Bxb1	A1
Bxz1	C1
Bxz2	A3
Caaw	Unclustered
Cabrinians	F1
Cactus	E
CadyPharon	Unclustered
Caelakin	A4
Caelum	Unclustered
Caesar	Unclustered
Cage	Unclustered
Cagedmage	A1
Caguel	Unclustered
Cain	None
Cairo	G
Cakepop	F1
Calandi231	Unclustered
Caldwell	Unclustered
Cali	C1
Caliente	Unclustered
Calirado	Unclustered
Calkins	Unclustered
CallofDoody	Unclustered
Cally	None
Calvin	Unclustered
Calvin1423	Unclustered
Calypso	Unclustered
Cambiare	G
Cambria	Unclustered
Cambridge	Unclustered
Camer	Unclustered
CamFighter	Unclustered
Campbell	Unclustered
Camperdownii	A4
Campustomato	Unclustered
Camro	Unclustered
Camus	Unclustered
Canadia	Unclustered
Canary	Unclustered
Candeohalysis	Unclustered
Cantor	Unclustered
Capa3613	Unclustered
CapnHook	Unclustered
CapnPlanet	Unclustered
Capo	Unclustered
Capricorn	Unclustered
CaptainKirk	Unclustered
CaptainSmuggle	Unclustered
CaptainTrips	F1
Caracal	Unclustered
Carcharodon	N
Carl	Unclustered
Carlos	Unclustered
Carlos11	Unclustered
Carlos12	Unclustered
Carlton	Unclustered
Carludy	Unclustered
CarlX	Singleton
Carly	Unclustered
Carmina	Unclustered
Carol	Unclustered
Carolina	Unclustered
CarpeDiem	Unclustered
CarrieJ	Unclustered
Carsan	Unclustered
Cartmen	Unclustered
Casbe	Unclustered
Casper	Unclustered
Casper1000	Unclustered
Casper30	Unclustered
Cass	Unclustered
Cassandrabaine	Unclustered
Castalia	Unclustered
Castiel	Unclustered
Castillo	Unclustered
Castle	Unclustered
Cat15	Unclustered
Catalina	A9
CatBug	Unclustered
CatchChoas	Unclustered
Catdawg	O
Catera	C1
Cathy	Unclustered
Catoctluckton	Unclustered
Catpaw	Unclustered
Catwoman	Unclustered
Caudill	Unclustered
Caudox	Unclustered
Cavaluma8	Unclustered
Caviar	Unclustered
CBaby	Unclustered
Ccsemp	Unclustered
CCurtis	Unclustered
CDDC	Unclustered
Cdunk	Unclustered
Ceci11	None
Cedar	A1
Cedasite	Unclustered
CeeJay	Unclustered
Ceibuss	Unclustered
Ceis	Unclustered
CellFie	Unclustered
Cello	Unclustered
Cemi	Unclustered
Centaur	Unclustered
Centroid	Unclustered
Centurion	Unclustered
Cerasum	F1
Cerberus	Unclustered
Cerberus21	Unclustered
Ceres	Unclustered
Cersei	Unclustered
Certamen	Unclustered
Cerulean	Unclustered
Ceto	Unclustered
CG28grabber	Unclustered
CgAm	E
CGeorge	Unclustered
Cgwhichard	Unclustered
Chachi	P
ChadA	Unclustered
ChadB	Unclustered
Chadwick	A5
Chah	B1
Chai	E
ChalupaB	Unclustered
Chameleon	Unclustered
Champ	Unclustered
Champ2010	Unclustered
Champagne	Unclustered
Champers16	Unclustered
Chanbicelli	Unclustered
Chance21	Unclustered
Chanceux	Unclustered
Chand	Unclustered
Chandler	B3
Changeling	A2
Chaos	Unclustered
Chaotic	Unclustered
Chargaff	Unclustered
Charity	A2
Charizard	Unclustered
Charlan	Unclustered
CharlesTrout	B3
Charlie	N
Charlie05	Unclustered
Charlie1	Unclustered
Charlie5	Unclustered
CharlieB	C1
CharlieBrwn	Unclustered
CharlieGBrown	B1
Charlotte	A1
Charm	Unclustered
Charon	Unclustered
Chaser	Unclustered
Chastity	Unclustered
Chauncey	Unclustered
Chautauqua	Unclustered
Chayyim	Unclustered
Chaz0914	Unclustered
Che	Unclustered
Che12	A2
Che8	F1
Che9c	I2
Che9d	F2
Checkmate	Unclustered
Cheebun	Unclustered
Cheekenpop	Unclustered
Cheeky	Unclustered
CheekyPuff	Unclustered
Cheerio	Unclustered
Cheetobro	K4
CheMahBo	Unclustered
Chempanal	Unclustered
Chenolovirida	None
ChenoWicz	Unclustered
Cheriba	A2
Cherry	Unclustered
Cherrybomb	Unclustered
Cherrybomb426	G
Chesed	Unclustered
Cheshire	Unclustered
Chester	None
Chester190	Unclustered
ChewTrain	Unclustered
Chewy	Unclustered
ChewyVIII	Unclustered
Chicharito14	Unclustered
ChickenPhender	C1
Chiddy	Unclustered
Chief117	Unclustered
Chiefchauwick	Unclustered
ChiefKeef	Unclustered
ChiefLongTail	Unclustered
ChienChien	Unclustered
Chikondi	F1
Chimera	Unclustered
Chimichanga	Unclustered
Chip	Unclustered
ChiPhiGuy	Unclustered
ChipMunk	A2
ChipNip	Unclustered
Chipper	Unclustered
ChippingIce	Unclustered
Chiquita	E
Chirese	Unclustered
Chloe	Unclustered
Chlomister	Unclustered
Choco	Unclustered
ChoiBaby	Unclustered
Cholly	Unclustered
Chopasama	Unclustered
Chorkpop	B1
Chowder	Unclustered
ChrIke	None
Chris91	Unclustered
ChrisnMich	B4
Chrissy	Unclustered
Chronos	Unclustered
Chub	Unclustered
Chubby	Unclustered
ChubbyBunny	Unclustered
Chuck	Unclustered
ChuckNorris	Unclustered
Chumley	Unclustered
Chunky	B1
ChunkyMonkey	Unclustered
Chupacabra	A10
Churr	Unclustered
Chyante	Unclustered
Cielo	Unclustered
CileyMyrus	Unclustered
CillBosby	Unclustered
Cinco	Unclustered
CincyZoo	Unclustered
Cinder	Unclustered
Cinderblock	Unclustered
Ciqala	Unclustered
Circulo	Unclustered
Cirso	Unclustered
Cjw1	E
CLach	None
Clairvoyant	Unclustered
Claptrap	Unclustered
Clarabelle	None
Clarence	None
Clarenza	A4
Clarice	Unclustered
Clarientosaur	Unclustered
Clasect4	Unclustered
Classymom	Unclustered
Claudia	Unclustered
Claudius	Unclustered
ClayGruber	Unclustered
Cleanandclear	Unclustered
ClearSpot	Unclustered
Clefto	Unclustered
Clementine	Unclustered
Cleom	Unclustered
CLES	Unclustered
ClintYeastwood	Unclustered
CLittleNinja	Unclustered
ClockworkO	Unclustered
CloudB	Unclustered
CloudWang3	A6
CloudyM	Unclustered
Clover	F1
Clslowpoke	Unclustered
ClumpyY	A2
Clumsy	Unclustered
Clyde	Unclustered
Clyde2013	Unclustered
Clyde788	Unclustered
Clydee	Unclustered
ClydeJulian	Unclustered
Clyve3000	Unclustered
CMaus	None
Cmilk	Unclustered
Coach	Unclustered
CoastalNC	Unclustered
Coatlicue	Unclustered
Cobra	B1
Coco	Unclustered
Coco0196	Unclustered
Coco1	Unclustered
Coco12	Unclustered
CoDe	Unclustered
Cody	Unclustered
Coffean	B1
Colbert	B1
Colebug	Unclustered
Colesidwell96	Unclustered
Coliseum2A	Unclustered
Collard	K5
CollegeProbz	Unclustered
Colleswan	Unclustered
Colonel	G
Colossus	Unclustered
ColvinP011	Unclustered
Comebacscmurda	Unclustered
ComeOnTyrone	Unclustered
Comet	Unclustered
Comets	Unclustered
Commander	K1
Compost	G
Compostia	B3
ConanOFey	Unclustered
Concepcion	Unclustered
ConceptII	A1
Concord	Unclustered
Condwa	Unclustered
Confuzzles	Unclustered
Conner	Unclustered
Connie	Unclustered
Conquistador	Unclustered
Conspiracy	A5
Constantine	Unclustered
Consuela	Unclustered
Contagio	Unclustered
Contagion	E
Contaxio	Unclustered
Content	Unclustered
Coog	A5
CooJo	Unclustered
CookahMonstah	Unclustered
Cookeite	Unclustered
Cookie	Unclustered
CookieMonster	Unclustered
Cookland	None
Cool	Unclustered
CoolGuy	F1
Coop931	Unclustered
CoopDeVille	Unclustered
Cooper	B4
Cooper6	Unclustered
Cooter	Unclustered
Cootie	Unclustered
CopernicusIII	Unclustered
CopiousEntity	Unclustered
Copperhead	Unclustered
Copycat	Unclustered
Cora	Unclustered
Coralreef	Unclustered
Corax	Unclustered
Cordi	Unclustered
Corky	A1
Corndog	O
Cornelius	Unclustered
Cornelius1	Unclustered
Cornwall	Unclustered
Corofin	B3
Corona	Unclustered
Corvlys	Unclustered
Corvo	A1
Corynthius	Unclustered
Cosmic	Unclustered
CosmicSans	Unclustered
Cosmo	V
Cotton	Unclustered
CountPlaqula	Unclustered
Courage	Unclustered
Courtanaly	Unclustered
CourtCourt	Unclustered
Courthouse	J
Cowboy	Unclustered
CowboyDan	Unclustered
CowPie	Unclustered
Coyote	Unclustered
Cozy12	Unclustered
CptKIRK	None
Cramman	Unclustered
Cranston	Unclustered
Crawphish	Unclustered
Crazycat	Unclustered
Creatorsjewel	Unclustered
Creed	Unclustered
CremePhraiche	Unclustered
Cresc10	Unclustered
CREW	K1
Crichton	Unclustered
Cricket	Unclustered
CrimD	K1
Cripfrainbeth	Unclustered
Critter	Unclustered
Crossroads	L2
Crouton	Unclustered
Crown10	Unclustered
Crownjwl	B1
Croy	Unclustered
CRStickyN3	Unclustered
Crums	Unclustered
CrunchyPB	Unclustered
Crush	A2
Cruu	Unclustered
Cruz	Unclustered
Cruz2014	Unclustered
CrymsonTyde	Unclustered
Cryptkeeper	Unclustered
Crysanity	Unclustered
CS1992	Unclustered
Cscmonster	Unclustered
CSenor	Unclustered
CSHtempo	Unclustered
CSylves2	Unclustered
Cthulhu	Unclustered
Cuco	A5
Cucumber	Unclustered
Cuddles	Unclustered
CUDI	Unclustered
Cuetip	Unclustered
Cueylyss	A1
Cujo	None
Culver925	Unclustered
Cuppycake	Unclustered
Curiosity	Unclustered
CuriousG	Unclustered
Curlin726Q	Unclustered
Curly	Unclustered
CurlyCheese	Unclustered
CurlyQ	Unclustered
Curmudgeon	Unclustered
Currie	Unclustered
CurryBear	Unclustered
Curtis	Unclustered
CuteCollette	Unclustered
Cutie	Unclustered
Cyca	Unclustered
Cyclopellen	Unclustered
Cyclops	Unclustered
Cygnus24	K2
Cymba	Unclustered
Cynogriffon	Unclustered
Cyrano24	Unclustered
Cyrus	Unclustered
Cyrus823	Unclustered
Czar	Unclustered
Czyszczon1	E
D29	A2
DABae	Unclustered
DaBear	Unclustered
Dabomb	Unclustered
DaBoss	Unclustered
Daedalus	Unclustered
Daenerys	F1
Daffodil	Unclustered
Daffy	B1
DaGeorge	Unclustered
Dagger	Unclustered
DaGr8est	Unclustered
Dahab	Unclustered
DaHileesi	None
DaHudson	A3
DaintyLady	Unclustered
Daishi	Unclustered
Daisi59	Unclustered
Daisy	B3
DaisySphir	Unclustered
DaisytheDog	Unclustered
Dajjr	Unclustered
Dakota	Unclustered
Dale	Unclustered
Dalek	Unclustered
Dalmations	Unclustered
Dalton	Unclustered
Damien	H1
DaMoLaTi	Unclustered
DancingQueen	Unclustered
Dandelion	C1
Dandelion2233	Unclustered
Dandy	Unclustered
Danforth	Unclustered
Danicole	Unclustered
Daniel	Unclustered
DanielGin	Unclustered
Danielle	Unclustered
Danirob16	Unclustered
Danny	Unclustered
Dante	F1
DaPantherClaw	Unclustered
Daphne	Unclustered
Daquan	Unclustered
DarkLord1994	Unclustered
Darknight	Unclustered
Darko11	Unclustered
Darth	Unclustered
DarthPhader	A12
DarthTater	Unclustered
Daryl	Unclustered
DaSnAkeTearz	Unclustered
Dauntless	Unclustered
David	Unclustered
DaVinci	A6
DavyJones	Unclustered
Dawtsy	Unclustered
Dayman	Unclustered
DBones	Unclustered
DC300k	Unclustered
DCNugh	A4
DD5	A1
DDDS	Unclustered
Deadmau5	Unclustered
DeadP	F1
Dean	Unclustered
Dean23	Unclustered
Deano	A4
Death	A2
Deatheater	Unclustered
Debbie87	Unclustered
DebbyT	Unclustered
Decimator	A4
DediKAtion	Unclustered
Dee12	Unclustered
Deepika97	Unclustered
DeeVee	Unclustered
Defenestrate	Unclustered
Defiance	Unclustered
Deihsitis	Unclustered
Deimos	Unclustered
DeinoVascul	Unclustered
DeLaCroix	Unclustered
DelawareWonder	Unclustered
Delicious	Unclustered
Delilah	C1
Delmarco	Unclustered
DeltaCharlie	Unclustered
Delylah	Unclustered
Delylah15	Unclustered
Dementor	Unclustered
Demilio	Unclustered
DemoMan	Unclustered
Dennis	Unclustered
Denniss	Unclustered
DennisUTC	Unclustered
DEomnivore	Unclustered
DerekJ2	Unclustered
DerFriede	Unclustered
Derp	Unclustered
Derrick	Unclustered
Descolada	Unclustered
Deshpanda	Unclustered
DesiGirl	Unclustered
Desmarais94	Unclustered
Desmond	F1
Despondency	Unclustered
Despotos	Unclustered
Desrazzo	Unclustered
Destahara	Unclustered
Destroya	Unclustered
Destroyah	Unclustered
Devin	Unclustered
Devourer	Unclustered
Devourer625	Unclustered
Devyn	Unclustered
Dewey	Unclustered
Dexie	Unclustered
Dexs	Unclustered
Dexter	Unclustered
Dextr3	Unclustered
DezLew	Unclustered
Dhanush	A4
DHBrownie	Unclustered
Diablo	Unclustered
Diamond	Unclustered
Diamonds	Unclustered
Diana	Unclustered
Dibber	Unclustered
Dicaprio	Unclustered
Diego	Unclustered
Dierkes	Unclustered
Dieselweasel	A3
Digging02	Unclustered
DiJulio	Unclustered
Diletta	Unclustered
Dilly	Unclustered
Dimas	Unclustered
Dimebag	Unclustered
Dimples	Unclustered
Dinozzo	Unclustered
Dione	Unclustered
Dionysus	Unclustered
Diplophanerum	Unclustered
Dipper	None
DipStick	Unclustered
Dipsy	Unclustered
Dirby	Unclustered
DirtMcgirt	F1
Dirtybirds	Unclustered
DirtyJoe	Unclustered
Disco	Unclustered
Ditto	B1
Divergent	Unclustered
Dixie	Unclustered
Dizma25	Unclustered
DizzyKitten	Unclustered
Django	Unclustered
Djembe23	Unclustered
DLane	F1
DLFriend	Unclustered
Dmpstrdiver	Unclustered
DNasty	Unclustered
Doane1302	Unclustered
Doane1303	Unclustered
Doane1304	Unclustered
Doane1305	Unclustered
Doane1306	Unclustered
Doane1307	Unclustered
Doane1308	Unclustered
Doane1309	Unclustered
DoaneSoccer	Unclustered
Dobby	Unclustered
Dobby08	Unclustered
DocIbu	Unclustered
Docus	Unclustered
Doge	Unclustered
Dogwood	Unclustered
Dolan	Unclustered
Dollie2	Unclustered
Dolly	Unclustered
DoloresDee	Unclustered
Domino	Unclustered
DomoArigato	Unclustered
Donald	None
Donatello	Unclustered
DonLou	Unclustered
Donna	Unclustered
Donovan	P
DonSanchon	B1
DontWorry	Unclustered
Donut	Unclustered
Doodle	Unclustered
DoodleBob	A1
Doodlebug	Unclustered
Doom	A1
Doopee	Unclustered
Dopa	Unclustered
Dopey	Unclustered
Dor110	None
Dora	Unclustered
Dori	Singleton
Dorothy	F1
DosMorph	Unclustered
DotDot	Unclustered
Dotie	Unclustered
DotProduct	F1
Dots	Unclustered
Dottie	Unclustered
Dotty	Unclustered
DoubleAA	Unclustered
Doubletrouble	Unclustered
Doubtfire	Unclustered
Doudou	Unclustered
Doug	Unclustered
DougVinnie	Unclustered
Doukliea	Unclustered
Dowdy	Unclustered
Dpka	Unclustered
Drac109	Unclustered
Dracula	Unclustered
Drago	F1
Dragonfly	Unclustered
Dragons293	Unclustered
DRAINger	Unclustered
Dranda	Unclustered
DrAstronaut	Unclustered
Drazdys	C1
DrDrey	E
Dream	Unclustered
Dreamboat	A1
DreamCatcher	A1
Dreamer	Unclustered
Dresco	E
DrHayes	Unclustered
Drizzy	Unclustered
DrMcninja	Unclustered
Drogon	None
Drom	Unclustered
Drookerz	Unclustered
DrPaul	Unclustered
DrThomas	None
Drupey	Unclustered
Druzhina	Unclustered
DS6A	Singleton
DTDevon	C1
Dubstep	Unclustered
DubyaDubya	None
DuchessDung	B1
Ducky	Unclustered
Duclinh	Unclustered
Duelemucho	Unclustered
DuffyC	B1
Dugg	Unclustered
Duhl	Unclustered
Duke13	J
Dumbledore	Unclustered
Dumbmud	Unclustered
Dumbo	E
DumDum	Unclustered
Dumphrey	Unclustered
Dumpling	A3
Duplicity	Unclustered
Durandal	Unclustered
Durfee	Unclustered
Durt	Unclustered
Dusk	E
Dutch	Unclustered
Dutchie	Unclustered
Dutchmen	Unclustered
Dwight	Unclustered
Dyanna	Unclustered
Dylan	O
DynamicUno	Unclustered
Dynamix	A1
DZ007	Unclustered
Dzaidins	Unclustered
Eagle	A4
EagleEye	A2
Eaglehorse	B2
Eapen	Unclustered
Earp	Unclustered
Earthworm	Unclustered
Earyn	Unclustered
Ebenezer	Unclustered
EBennet	Unclustered
Ecce	Unclustered
Echild	A2
Echo	Unclustered
Eclipse	Unclustered
Ecquador	Unclustered
Edgar	Unclustered
Edmond	Unclustered
Edna	Unclustered
Edtherson	A1
Edugator	K5
Edward	Unclustered
EeGee	Unclustered
Eerie	Unclustered
Eeyore	Unclustered
Effy	Unclustered
Efra2	Unclustered
EGMO	None
Egyptian	Unclustered
Eichn3r	Unclustered
Eidsmoe	A9
Einahpets	Unclustered
Einstein	Unclustered
Eint	Unclustered
EJay13	Unclustered
Ekanem	Unclustered
Ekundayo	Unclustered
Elah	Unclustered
Elastigirl	Unclustered
Elbueno	Unclustered
ElCapitanDos	Unclustered
ElDiablo	Unclustered
Eldridge	Unclustered
Eleanor	Unclustered
Electra	Unclustered
EleFH1	Unclustered
Elefu	Unclustered
Eleventhour	Unclustered
Elfin	Unclustered
ElFluff	A2
Elinfector	Unclustered
Elio	Unclustered
Elitch	Unclustered
Elite2014	E
Eliza	Unclustered
Elky	Unclustered
Ella773	Unclustered
Ellatie	Unclustered
Ellemm	Unclustered
Ellen	Unclustered
Ellie	Unclustered
Elliker	Unclustered
Elmo1	Unclustered
Elmo2	Unclustered
ElNino94	Unclustered
Elph10	E
ElPollo13	Unclustered
ElSilvo	A10
ElTiger69	A5
Elucidator	Unclustered
Elusive	Unclustered
Elvis	Unclustered
Elysium	Unclustered
EmBarker	Unclustered
Ember	Unclustered
Embiidina	Unclustered
Emeka	Unclustered
Emerica	Unclustered
Emerson	K1
Emigrams4	Unclustered
Emily	Unclustered
EmilyOH	Unclustered
Emiris	Unclustered
EmiVy	Unclustered
EmJay10	Unclustered
Emmanuel	Unclustered
EmmyMG	B1
EMNET	Unclustered
Emoney	Unclustered
EMorton	Unclustered
Empress	F1
EmpTee	B1
Emschmag	Unclustered
EmToTheThree	C1
Enchante	Unclustered
Ender	L1
Enders	Unclustered
Endosmosis	Unclustered
Engr1325	Unclustered
Enkatz	Unclustered
Enkosi	K1
Ennis	Unclustered
Enola	Unclustered
Enrique	Unclustered
Enterprise	L2
Enviro	Unclustered
Enyo	Unclustered
Epegasus	Unclustered
Epeneto	Unclustered
Epharess	Unclustered
Ephemera	Unclustered
Epic	Unclustered
EpicPhail	A3
Epoch	A2
Epoh94	Unclustered
Epoli	Unclustered
Eppy	Unclustered
Eprice	Unclustered
Epsilon	Unclustered
Equemioh13	A2
Equusmess2010	Unclustered
Eraiser	Unclustered
Erdnod	K1
Eremos	B1
Eric	Unclustered
EricB	A6
EricMillard	J
Eris	A4
Eris320	Unclustered
Ernie	Unclustered
ErnieJ	C1
Eros	A4
Error404	Unclustered
Erwin	Unclustered
Esal4	Unclustered
Escapa	Unclustered
EscapingEileen	Unclustered
Esme34	Unclustered
Espica	Unclustered
Estave1	F1
Estella	F1
Estelle	Unclustered
Esty	Unclustered
ET08	C1
Et2Brutus	A11
EtowahDuri	Unclustered
Etuk	Unclustered
Eubie	Unclustered
Euclid	Unclustered
Eugene	Unclustered
Eugenen	Unclustered
Euphoria	A1
Eureka	E
Eurynomos	Unclustered
Evanesce	Q
Evangelion	Unclustered
Evanhalo	Unclustered
Evaristus	Unclustered
Evasive007	Unclustered
Eventhorizon	Unclustered
Everdeen	Unclustered
Evergreen9	Unclustered
EvilGenius	A2
Excalibur	Unclustered
Excido	Unclustered
Exia4	Unclustered
Exp626	Unclustered
Expelliarmus	A8
ExploransVagus	Unclustered
Exxus285	C1
Ezel	Unclustered
Ezio	Unclustered
EzioAuditore	Unclustered
EzraLuxe	Unclustered
Ezzo	Unclustered
Fab4	Unclustered
Fabio	Unclustered
Fabiola	Unclustered
Fabiolayun	Unclustered
Fabulous	Unclustered
Faee	Unclustered
Fagoz	Unclustered
Failure	Unclustered
Faith	Unclustered
Faith1	L2
Fameo	A2
FancyFrancie	Unclustered
Fanfare	Unclustered
Fang	B1
Fantasia	J
Fantasticleeze	Unclustered
Faraan	Unclustered
Farber	A3
FarreGround	Unclustered
Fascinus	A1
FatAlbert	Unclustered
Fatmike	Unclustered
Fatumira	Unclustered
Fatz	Unclustered
Faustulus	Unclustered
Faviola	Unclustered
Fawkes	Unclustered
Faze	Unclustered
FBx3	Unclustered
Feedom27	Unclustered
Fefe	Unclustered
Fefferhead	Unclustered
Felakuti38	Unclustered
Felandrew	Unclustered
Feld1	Unclustered
Felicity	Unclustered
Felipe	Unclustered
Felix	Unclustered
FelixPhelicis	Unclustered
Fenix	Unclustered
Fenixius	Unclustered
Fenton	Unclustered
Fenworthy	Unclustered
Ferb	Unclustered
Ferhersher	B1
Ferrari	Unclustered
Ferraro	Unclustered
Ferris	Unclustered
Ferris10	Unclustered
Festival	Unclustered
Feverlove	Unclustered
Fezzik	None
FHAGEBLASTER	Unclustered
Fibonacci	A11
Fido	None
Fidos	Unclustered
Fieldrain	None
FiFi	Unclustered
Fighter	Unclustered
Fiji13	Unclustered
Filch	Unclustered
Filuzino	Unclustered
FinAlly	Unclustered
Findley	K2
Finesse	Unclustered
Finger	Unclustered
Finicky	Unclustered
Finley	Unclustered
Finn	Unclustered
Fiona	E
Fionnbharth	K4
Firebolt	Unclustered
Firecracker	O
Firefly	Unclustered
Firehouse51	Unclustered
FireRed	E
Firework	Unclustered
Firnen	Unclustered
FirstPlacePfu	Unclustered
FirstTimeCharm	Unclustered
Fishburne	P
FishermanGlory	Unclustered
FittySent	Unclustered
Fitzgermald	Unclustered
Fitzroy	Unclustered
Fitzwilliam	Unclustered
FiveGuys	Unclustered
Fiver	Unclustered
Fiza	Unclustered
Fjola	Unclustered
Fjorgyn	Unclustered
Flagship15	Unclustered
FlagStaff	G
Flame	Unclustered
Flamingo	Unclustered
Flapjack	A4
Flash	K1
Flat30052	Unclustered
Flavaflage	Unclustered
Flemington	Unclustered
Flex105	Unclustered
Flexxx	Unclustered
Flick	Unclustered
Flip	Unclustered
Flipper	Unclustered
Flitter	Unclustered
FloAmmen	Unclustered
Flohchen	Unclustered
FloMo	A3
FloP831	Unclustered
Florence	Unclustered
Floriant	Unclustered
Florinda	F1
Flounder	Unclustered
Flounder05	Unclustered
FlowerChild	A1
Flowery	Unclustered
Fluf	Unclustered
Fluffles	Unclustered
Fluffy	Unclustered
FluffyBonez	Unclustered
Fluffyclown	Unclustered
FluffyNinja	B1
FluffyPuff	Unclustered
Flux	A4
FlyingNarwhal	Unclustered
Foda	Unclustered
Foresdaddy	Unclustered
ForGetIt	A5
FormGarden	Unclustered
Formics	Unclustered
Forsytheast	A1
Fortuity	Unclustered
FortunaTyche	Unclustered
FortyTwo	Unclustered
Foster	Unclustered
Founder	Unclustered
Fountainhead	Unclustered
FourScience	Unclustered
FourStarNutty	A1
Fowler	Unclustered
Fox23	Unclustered
Foxy	Unclustered
Foxy007	Unclustered
Fpiml	Unclustered
Franca	Unclustered
Frances	Unclustered
Francis	Unclustered
Francis23	Unclustered
Franco	Unclustered
Frankenstein	Unclustered
Frankicide	None
Franklin	Unclustered
FrankReynolds	Unclustered
FrannyJoe	None
Franz	Unclustered
Frarko	Unclustered
Freckle	Unclustered
Freckles	Unclustered
Fred	Unclustered
Freddy	Unclustered
Frederick	B4
Fredward	A8
Freedom	Unclustered
Freedom27	Unclustered
Freeway	Singleton
FreshPrince	Unclustered
FriarPreacher	B1
Friday	Unclustered
Friedrich	Unclustered
FriendlyEddie	Unclustered
FriNor	Unclustered
Fritjof	Unclustered
Frodo	Unclustered
Frontgrass	Unclustered
Frosty	Unclustered
Frosty2	Unclustered
Frosty24	G
Froyo	Unclustered
Frozone21	Unclustered
Fruitcake	Unclustered
Fruitloop	F1
Fudge	Unclustered
Fuego	Unclustered
Funbox	Unclustered
Fungee	Unclustered
Funke	Unclustered
Funston	A4
Funz	Unclustered
Fushigi	A1
Fussy	Unclustered
Fuzelihle	Unclustered
FuZGrapes	A4
FuzyWatermelon	Unclustered
Fuzz	Unclustered
FuzzBall	Unclustered
Fuzzy	Unclustered
FuzzyDuck	Unclustered
FuzzyPearl	Unclustered
FuzzyWuzzy	Unclustered
Fuzzz	Unclustered
Gaara	Unclustered
GabDaniAV	Unclustered
Gabe	Unclustered
Gabi	Unclustered
Gabigail	Unclustered
Gabriel	None
Gabuist04	Unclustered
Gadjet	B3
Gadost	A4
Gaetano	Unclustered
GageAP	A1
Gaia	Singleton
Gail	Unclustered
Gailstorm	Unclustered
Gaius	A4
Gajjala	Unclustered
Galanaz	Unclustered
Galaxy5	Unclustered
Galgraith	Unclustered
Galileo	Unclustered
Galleon	Unclustered
Galway	Unclustered
GameOfDarts	Unclustered
Gamma	Unclustered
Gandalf	Unclustered
Gandalph	Unclustered
Gandrian	Unclustered
Gannon	Unclustered
Gansey	K1
Ganymede	Unclustered
Gardann	Unclustered
GardenGnome	Unclustered
Gardeno	Unclustered
Gardregs	F1
GargleMe	Unclustered
Garlic	Unclustered
Gary1	Unclustered
Gates	Unclustered
GatorBait	Unclustered
Gatsby	Unclustered
Gattaca	S
Gattron12	Unclustered
GayleyAve	Unclustered
GDiSilvio8	Unclustered
Gee6	Unclustered
Gee8	Unclustered
Geez	Unclustered
Geezer	Unclustered
Geezy	None
Gemini	Unclustered
Gemini10	Unclustered
Gemini91	Unclustered
Geminio	Unclustered
Gemm	Unclustered
Gendisarray	F1
GeneCoco	B1
Genesis	F1
Gengar	K5
Genghis	Unclustered
GenghisKhan	Unclustered
Genie	Unclustered
Geoadisonoki	Unclustered
Geoff	Unclustered
Geoffrey	Unclustered
GeoffreySr	Unclustered
Geomitrus	Unclustered
George	A5
George1	Unclustered
Georgiaboss	Unclustered
Georgie	Unclustered
GeorgySmorgy	Unclustered
Gerardo	Unclustered
GERmaine	Unclustered
GERMaineOneal	Unclustered
GermDevil	Unclustered
Gertrude	Unclustered
Gettysbug	Unclustered
Ghetti	Unclustered
Ghost	C1
Ghoti	Unclustered
Gibby	Unclustered
Gibby253	Unclustered
Giddykiddy	B1
GigiCha853	Unclustered
Gilbert	Unclustered
Giles	Q
Gilly	Unclustered
Gilman	Unclustered
Ginfree	Unclustered
GingkoMaracino	A3
Gingr	Unclustered
GinoB17	Unclustered
Ginona	Unclustered
Giovanni	Unclustered
Girafales	F1
Giraffe	Unclustered
Giranomo	Unclustered
Girly	B1
Girmay	Unclustered
Girouard23	Unclustered
Girr	F1
Gitchigami	Unclustered
Gizmo	C1
GL23	Unclustered
Gladiator	A6
Gladis	Unclustered
Glam	Unclustered
Glass	B2
GlassSlipper	Unclustered
GlassVase	Unclustered
Glee95	Unclustered
Glen	Unclustered
GlenCoco	Unclustered
GlenSpring	Unclustered
Glimmer	Unclustered
Glinda	Unclustered
Glitter	Unclustered
Glitzy	Unclustered
Gloria	Unclustered
Glot10	Unclustered
Glower	Unclustered
GMia	Unclustered
Gmoney	Unclustered
GnarlyMarley	Unclustered
Gnome	Unclustered
GNR19	Unclustered
Goat	Unclustered
GoatGod	Unclustered
Gobber	Unclustered
Goddess	Unclustered
GODDESSA	Unclustered
Godfather	Unclustered
Godines	B2
Godot	Unclustered
Godzilla	Unclustered
Goethe	A2
Goggins1	Unclustered
GoHawks	Unclustered
Goku	E
GoldenBug	Unclustered
GoldenDragon	Unclustered
GoldenTicket	Unclustered
Goldstein	Unclustered
GolfWang	Unclustered
Goliath	Unclustered
Goliath2	Unclustered
Gollum	Unclustered
GolyathLS	Unclustered
Gomashi	G
Gonswagga	Unclustered
Gonzo	Unclustered
Goob	Unclustered
Goober	Unclustered
Goodwil1	Unclustered
Goodwinae	Unclustered
Goofy	Unclustered
Goon	Unclustered
Goose	A10
Goosebump	Unclustered
Gossamer	Unclustered
Gossyp	Unclustered
Gouse	Unclustered
GovtShutdown	Unclustered
Grabowski	Unclustered
Grace	Unclustered
Gracie1	None
Graduation	A1
Gramoney	Unclustered
Grand2040	Unclustered
GrandDaddy	Unclustered
Grassblade	Unclustered
Gravata	A3
Gravemind	Unclustered
Grawe22	Unclustered
Grayson	Unclustered
GreaseLightnin	P
GreatHanson	Unclustered
Greatness	C1
GreedyLawyer	A6
Greenbean	Unclustered
Greendale	Unclustered
Greenhalo	Unclustered
Greenie	Unclustered
Greenland	Unclustered
GreenLantern	Unclustered
GreenMachine	Unclustered
GreenMonsta	Unclustered
GreenRanger	Unclustered
Gregor	Unclustered
Gremlin	Unclustered
Greta	Unclustered
GridersLegacy	A2
Griffin	Unclustered
Griffindor	Unclustered
Grigor	Unclustered
Group4X	Unclustered
Grover	Unclustered
Grub	Unclustered
Grum1	A3
Grumbly	Unclustered
GSquared	Unclustered
Guaili	Unclustered
Guanica15	Unclustered
Guayacan22	Unclustered
GUBulldog	Unclustered
GucciHolliday	Unclustered
GucciTheChosen	Unclustered
GUchi	Unclustered
Gudvibrations	Unclustered
Guerra	Unclustered
Guerrera	Unclustered
Guevara	Unclustered
Guido	Unclustered
Guimauve	K1
Gullie	Unclustered
Gulliver	Unclustered
Gulsi	B3
Gumball	D1
GUmbie	F1
GummyWorm	A1
GumRock	Unclustered
Guna	Unclustered
GunFin	Unclustered
GunnyMacintosh	Unclustered
GuruvPharout	Unclustered
GusGus	Unclustered
GusGus4	Unclustered
Guss	Unclustered
Gutt	Unclustered
GutterK	Unclustered
Gyarad	B1
Gzoman	Unclustered
H20melon	Unclustered
Haddad	Unclustered
Hades	F1
Hagood	Unclustered
Hagrid	Unclustered
Hagrid1	Unclustered
HaHaBear	Unclustered
Hails2k12	Unclustered
HakunaMatata	Unclustered
Haleema	B1
Haley	Unclustered
HaleysComet	Unclustered
HalfEM	Unclustered
Halie	Unclustered
HaLiK192	Unclustered
Halley	J
Halloween	B4
Halo	G
Halordan	Unclustered
Hamann	Unclustered
Hamid	Unclustered
Hammer	A6
Hammerhead	Unclustered
Hammock	Unclustered
Hampton	Unclustered
HamSlice	A4
HamsterHuey	Unclustered
Hamulus	F1
Hannah	Unclustered
HanPay	Unclustered
HanShotFirst	A1
Hansol	Unclustered
HansPay	A1
Happika	Unclustered
HappyPlague	Unclustered
Hardison	Unclustered
Hare	Unclustered
Harold	Unclustered
Harper	Unclustered
Harris	Unclustered
Harrisonburg	Unclustered
HarrySpotter	C1
HarshDADDY	Unclustered
Harvey	B1
Hasircoglu	Unclustered
Hasselhoff	Unclustered
HaveUMetTed	Unclustered
Havighurst	Unclustered
Havoc	Unclustered
Haway07	Unclustered
Hawkers	Unclustered
Hawkeye	D2
Haylo26	Unclustered
Haze	Unclustered
Hazel	Unclustered
Hazelgrace	Unclustered
Hazelnut	Unclustered
Headache	Unclustered
Heathcliff	B3
Heavican	Unclustered
Hebrews619	Unclustered
Hecate	Unclustered
Hector	Unclustered
Hedgerow	B2
Heffalump	A2
Heftyboy	Unclustered
Hegedechwinu	F1
Heimerdinger	Unclustered
Heisenberg	Unclustered
Heisenburg	A4
Hekiphino	Unclustered
Held	B1
HelDan	A3
Helen	Unclustered
Helena123	Unclustered
Helena23	Unclustered
HelenS	Unclustered
Helios	Unclustered
Heliox	Unclustered
HelterSkelter	Unclustered
Hemo	Unclustered
Hendricks1	Unclustered
Henrietta	Unclustered
Henry	E
Henry13	Unclustered
HenryGreen	Unclustered
Heracleon	Unclustered
Herak	Unclustered
Herbert	Unclustered
Herbie	Unclustered
HerbSipe	None
Hercules	Unclustered
Hercules11	A3
Heretic	Unclustered
Hermes	Unclustered
Hermione	Unclustered
HermoinePhanger	Unclustered
Hero	Unclustered
HeroGeorge7	Unclustered
HerpaDerpicus	Unclustered
Hertubise	B1
Hestia	Unclustered
Hetaeria	B1
Heterodoxy	Unclustered
HeWhoMustBNamd	Unclustered
Hex4	Unclustered
Hexamo	Unclustered
Hexx	Unclustered
Hexxus	Unclustered
Hezekiah	Unclustered
HH92	Q
HHMen	Unclustered
Hickenlooper	Unclustered
HideAndSeek	Unclustered
Higgins	Unclustered
HightowerMa	Unclustered
Higo	Unclustered
Hijacker	Unclustered
Hillabee	Unclustered
HINdeR	A7
Hippocampus	Unclustered
Hippocrates	None
Hiro	Unclustered
Hobbes	Unclustered
Hobbit	Unclustered
Hobo	Unclustered
Hodge17	Unclustered
Hodgin	Unclustered
Holli	A4
Hollificious	Unclustered
Holly	Unclustered
Holzmeister	Unclustered
Homophones	Unclustered
Homura	K1
Honcho	Unclustered
Honesty	Unclustered
HoneyBadger	Unclustered
Honeybun	Unclustered
Honeycomb	Unclustered
Honoreattici	Unclustered
Hook	Unclustered
Hoosier	Unclustered
Hope	G
Hope4ever	A1
HopeBulldawg	Unclustered
Hopey	E
Hopi	Unclustered
Hopinn	Unclustered
Hoppy	Unclustered
Horchata	B1
Horowitz	Unclustered
Hortencia	Unclustered
Hortensius	Unclustered
Horti	Unclustered
Hortus	Unclustered
HotMessXpress	Unclustered
HotSauce	Unclustered
Houdini	Unclustered
Houston	Unclustered
Howie	Unclustered
HowieHo	Unclustered
HUBlackburn13	Unclustered
Hudson	Unclustered
Huelsa	Unclustered
Huffalump	Unclustered
HufflyPuff	E
Hughbert	Unclustered
Hughesyang	Unclustered
Hugo	Unclustered
HUHilltop	P
Humbert	K3
Humble	Unclustered
Humdinger	Unclustered
Hummingbird	Unclustered
Humpfree	Unclustered
Humphrey	Unclustered
Humphrey7	Unclustered
Humphry	Unclustered
Hundenbiter	Unclustered
Hundini	Unclustered
Hungry	Unclustered
Hunhun	Unclustered
Hunnae	Unclustered
Hunniedukes14	Unclustered
Hunt	Unclustered
HUNT11	Unclustered
Hunter	Unclustered
Hutc2	A11
Hydra11	Unclustered
Hydrafoxglove	Unclustered
Hyokun	Unclustered
Hyperbowlee	K2
Hypertavi	None
HyRo	Unclustered
Iakalam	E
Ibhubesi	F1
IBzum	Unclustered
Icarus	Unclustered
Iceburgh	Unclustered
Iced	Unclustered
IceKajum	Unclustered
Iceman	None
IceNine	Unclustered
Ichabod	A1
IChooseYou	Unclustered
ICleared	A4
IggieSem	Unclustered
Iggy	Unclustered
IggyAzalea	Unclustered
Ignobilis	Unclustered
Ignotis	Unclustered
Igor	Unclustered
IGotNext	Unclustered
Ihana	Unclustered
Ikeja	Unclustered
Ikkitousen	Unclustered
Ilea	Unclustered
ILeeKay	A1
Illmatic	Unclustered
Illumine	Unclustered
ILMioBello	Unclustered
Ilumni	Unclustered
Imbricus	Unclustered
Immanis2	Unclustered
Imp48	Unclustered
Imperio	Unclustered
Impossible	Unclustered
Inaway	Unclustered
Incendium	Unclustered
Inception98	Unclustered
Incognito	Unclustered
Indecision	Unclustered
Indringer	Unclustered
Industria	Unclustered
Infecti	Unclustered
Inferno8Ten	Unclustered
Infettiv	Unclustered
Infinite	Unclustered
Infinitum	Unclustered
Infinity21	Unclustered
Infinity45	Unclustered
Infotech	Unclustered
Inigo	Unclustered
Inspector	Unclustered
InterFolia	C1
Interokirkus	None
IntrepidT	Unclustered
Intrinity	Unclustered
Invein	Unclustered
Inventum	F1
Inverness	Unclustered
Invictus	Unclustered
InYourPhace	Unclustered
Iosceha	Unclustered
IPP	B1
Ipsizzle	Unclustered
Iracema64	A4
Irene	Unclustered
IreneMarie	Unclustered
Iris	Unclustered
IrishSherpFalk	Unclustered
IronGiant	Unclustered
IronMAGE	Unclustered
IronMan	A2
Irony	Unclustered
Irwin2	Unclustered
IsaacEli	B1
IsabellPL	Unclustered
IshmaelIII	A11
Isis	Unclustered
Island3	I1
IsleOfEwe	Unclustered
Itis	Unclustered
ItsATrap	Unclustered
ItsFiiiine	Unclustered
ItsLate14	Unclustered
Itsoweezee	Unclustered
Iven	Unclustered
Iverknight	Unclustered
Iyee	Unclustered
J2Kore	Unclustered
JAAK	Unclustered
Jabbawokkie	F2
Jabiru	A5
JaCa	Unclustered
JacAttac	B1
JacieCarr	Unclustered
JacketPride	Unclustered
JackieO	Unclustered
Jackson	Unclustered
Jacob	Unclustered
Jade	Unclustered
JADent1	Unclustered
JahGang	Unclustered
Jal1	Unclustered
Jala25	Unclustered
Jalapeno	Unclustered
Jalapeno470	Unclustered
Jali	Unclustered
JAM17	E
Jamaica	Unclustered
JAMaL	B4
JaMar	Unclustered
Jamarb	Unclustered
Jambi	Unclustered
Jameela	Unclustered
JamesB007	Unclustered
Jameskc	None
JamesKirwan	Unclustered
Jamie	Unclustered
JamiesaursRex	Unclustered
Jamison	Unclustered
JamRock	Unclustered
Jane	G
JANK	Unclustered
Janya	Unclustered
Jaqen	Unclustered
Jaraaj	Unclustered
JaRes1	Unclustered
Jasfine	Unclustered
Jasiernaha	Unclustered
Jason	Unclustered
Jasper	A1
JasperVT	Unclustered
Jass	Unclustered
JAWS	K1
Jaybaybay	Unclustered
Jayden	Unclustered
Jayendra	Unclustered
JayJay17	Unclustered
Jayla	Unclustered
Jayney	Unclustered
JayNwok	Unclustered
Jbone	B1
JC27	A1
JCaesar	Unclustered
JCfoboat	A1
JDKninja	Unclustered
JeanKris4	Unclustered
Jeb2G	Unclustered
Jebeks	P
JebK	Unclustered
JeckyllnHyde	None
Jeddi	Unclustered
JEDITREY	Unclustered
JEDZ	Unclustered
Jeet	Unclustered
Jeevi	Unclustered
Jeff	Unclustered
Jeffabunny	A6
JefferySwag	Unclustered
Jeffy	Unclustered
Jegeland	Unclustered
Jekreck	Unclustered
Jekyll	Unclustered
JelloSpots2012	Unclustered
Jellybean	Unclustered
Jemm	Unclustered
Jemsun	Unclustered
Jenika	Unclustered
Jenisha	Unclustered
Jenjami	Unclustered
Jenla	Unclustered
Jennebrodock	Unclustered
Jenuma	Unclustered
Jeon	Singleton
Jerlich	Unclustered
Jerm	A2
Jerm2	Unclustered
Jerry	Unclustered
Jerry13	Unclustered
Jerry37	Unclustered
Jersey	K1
Jersey23	Unclustered
JerseyBadland	Unclustered
Jessabelle	Unclustered
Jessar	Unclustered
JesseIII	Unclustered
Jessleigh	Unclustered
JessTann825	Unclustered
JetBlade	A4
Jethro	Unclustered
JEvan1A	Unclustered
Jevonne	Unclustered
JewelBug	A6
Jewels2000	Unclustered
JHC117	A3
JhuBrianLo	Unclustered
Jibo	Unclustered
Jicshroom	Unclustered
Jicshroom2	Unclustered
Jiffy	Unclustered
Jiger	Unclustered
Jillium	Unclustered
JillyBilly	Unclustered
Jimmy	Unclustered
Jimmy2shoes	Unclustered
JimmyD	Unclustered
JimmyN	Unclustered
JimmyP	Unclustered
JimmyRoo	Unclustered
Jims	Unclustered
Jinger	Unclustered
Jingle	Unclustered
Jingleheimer	Unclustered
Jinpika	G
Jinx	Unclustered
JiUnit	Unclustered
Jiwizz	Unclustered
JLyman	Unclustered
Jmac	Unclustered
JMaddy	Unclustered
JMan28	Unclustered
JMButler	Unclustered
JMeg	Unclustered
Joan16	Unclustered
JoAnB	Unclustered
JoanScott	Unclustered
Job42	F1
Jobu08	A3
Joby	Unclustered
Jodi	Unclustered
JoeDirt	L1
JoeDirt1	Unclustered
Joel	Unclustered
Joey	Unclustered
Jogo	Unclustered
Johan	Unclustered
John	Unclustered
JohnathanWest	Unclustered
JohnCalvin	Unclustered
JohnSpot	Unclustered
JoJo	Unclustered
JoJo13	Unclustered
Joker	Unclustered
Jokester	Unclustered
Joline	Unclustered
Jomaryosh	Unclustered
Jomegel	Unclustered
Jomungandr	Unclustered
Jones	Unclustered
Jonesie	Unclustered
JoongJeon	A4
Jordan1	Unclustered
JoreskiHCFM	Unclustered
Joric32	Unclustered
JorisIII7	Unclustered
Jorma	Unclustered
Joseph	Unclustered
JosetteG5	Unclustered
Joshi10	Unclustered
JosJos	Unclustered
Jotojudy	Unclustered
Journey13	A2
Jovie	Unclustered
Jovo	A5
Joy99	K1
Joyce	Unclustered
JSoil	Unclustered
Jsquared	A2
Juan	None
Juanamari	Unclustered
Juarez	Unclustered
Judas	Unclustered
Juggernaut	Unclustered
Jukes	Unclustered
Juliette	Unclustered
Julio	None
Julius	B2
Jumie	Unclustered
JunBug39	Unclustered
June	Unclustered
JungleTruffle	None
Junno	Unclustered
JuRM126	Unclustered
JustDirt	Unclustered
Justin1	Unclustered
JustinTime	Unclustered
JustKidding	Unclustered
Jwalker	Unclustered
Kabul	Unclustered
Kai316	Unclustered
Kaidontomous	Unclustered
Kaii	Unclustered
Kaiser	Unclustered
Kaladin	Unclustered
Kalaji	Unclustered
Kalamazoo	Unclustered
Kali	None
Kalikimaka	F1
Kalliden	Unclustered
Kaluza	Unclustered
Kamara	Unclustered
Kamehameha	Unclustered
Kami	Unclustered
Kamikaze12	None
Kamiyu	B3
Kammatt	Unclustered
Kamoniux	Unclustered
Kampy	A4
Kanati	Unclustered
Kanavar	Unclustered
Kang	Unclustered
Kanhai	Unclustered
KANIA	Unclustered
Kanika97	Unclustered
KansoShinTei	Unclustered
Kanye	E
KanyeSouth	Unclustered
Kapow	Unclustered
Kappy	Unclustered
Karl	Unclustered
Karlek	Unclustered
Karma	Unclustered
Karrren	Unclustered
Karso	Unclustered
Kasper	Unclustered
Kass	Unclustered
Kat63	B1
Katalya	Unclustered
Katamari	Unclustered
Katara	Unclustered
KatAttack	A1
Katiebelle	Unclustered
KatieWard	Unclustered
Katniss	Unclustered
Katra	Unclustered
KatSinclair	Unclustered
Kattail	Unclustered
Kaufman	Unclustered
Kawisima	N
KayaCho	B4
KayGrayson	Unclustered
KayKardashian	Unclustered
KaylaPaige01	Unclustered
Kayman	Unclustered
Kazan	A6
KBG	A1
Keda2	Unclustered
KeDo11	Unclustered
Kee91	Unclustered
Keebler	Unclustered
Keepinitweird	Unclustered
Kela12	Unclustered
Kelanie	Unclustered
Kellix	Unclustered
Kelly71	Unclustered
Kelryn	G
Kelseysface	Unclustered
Kemet	Unclustered
Kemma	Unclustered
Kempella	A2
Kemsah	Unclustered
Kendrick	Unclustered
KenGen	Unclustered
Kenico	Unclustered
Kennedy	Unclustered
Kenneth	Unclustered
Kenny	Unclustered
KenWill13	Unclustered
Kenya1	Unclustered
Kerfuffle	Unclustered
Kermit	Unclustered
Kermit25	Unclustered
Kermit7	Unclustered
KeRo	Unclustered
Kersh	Unclustered
Kert	Unclustered
Keshu	K3
Kessi	Unclustered
Kevin	Unclustered
Keylime	Unclustered
KFPoly	A4
Khaleesi	C1
Khamil	Unclustered
Khan	Unclustered
Khanvict	Unclustered
Kharne	Unclustered
Khatoon	Unclustered
Kheth	B2
Khoala	Unclustered
Khoshekh	Unclustered
Khosi	Unclustered
KHunt17	Unclustered
Kiba123	Unclustered
Kibe	Unclustered
Kidprophet	G
Kiki	Unclustered
Kikipoo	B1
Kilgore	Unclustered
Killa	Unclustered
KillerD	Unclustered
KillerTomatoes	Unclustered
Kimberlee	Unclustered
Kimberlium	Unclustered
KimmiR	Unclustered
Kimya	Unclustered
Kinbote	Q
King	Unclustered
Kingfisher	Unclustered
KingHenry3rd	Unclustered
KingLeonidas	A1
Kingsley	Unclustered
KingSt	A2
KingVeVeVe	B1
Kinky	Unclustered
Kinrose	Unclustered
Kirby	Unclustered
Kirk	Unclustered
Kirschen	Unclustered
Kirt	Unclustered
Kise112	Unclustered
Kishmeesh	None
KiSi	K1
Kismo	Unclustered
KitCat	None
Kitrick	Unclustered
Kitsune	Unclustered
KittenMittens	A10
Kiwi	Unclustered
Klatter	Unclustered
Klaus	A9
Klein	J
Kloppinator	B1
KLucky39	B1
Kmae	Unclustered
Kmla	Unclustered
KNel	Unclustered
KoalaBearAlpha	Unclustered
Kobe	Unclustered
Kobi2	Unclustered
Koda101	Unclustered
Kodama	Unclustered
KOGaga	Unclustered
Koguma	C1
Kohukohu14	Unclustered
Koii	Unclustered
Kojot	Unclustered
Konstantine	H1
Kookabura262	Unclustered
Kookaburra262	Unclustered
Koralia	Unclustered
Kore	Unclustered
Koriv	Unclustered
Kostya	E
Kotez	Unclustered
Kova	Unclustered
Kozdronek	Unclustered
Kpossible	Unclustered
Krakatau	F1
Kraken	Unclustered
Krane	Unclustered
Kratark	A4
Kratio	K5
Kreacher	Unclustered
Krin	Unclustered
Krisica	Unclustered
Kristin	Unclustered
Kristoff	Unclustered
Kristy	Unclustered
Kronk	Unclustered
Kronos	Unclustered
KROO	Unclustered
Krouse	Unclustered
KRPa	G
Krzemiun	None
Ksiph42	Unclustered
KSSJEB	A1
KSweat	Unclustered
Kugel	A1
Kujo	Unclustered
Kumar	Unclustered
Kupalo	A2
Kushal	Unclustered
Kuzco	Unclustered
Kwadwo	B1
Kwonmj	Unclustered
Kyett	Unclustered
Kykar	A1
Kyrie	Unclustered
Kyukies	Unclustered
L5	A2
La7X	Unclustered
LaAsesina	Unclustered
LaBel	Unclustered
Labeybaby	Unclustered
Labrozzi	Unclustered
LAChamna	Unclustered
LaChupacabra	None
Lack1ng	Unclustered
Lackdaddy	Unclustered
Lacuna	Unclustered
LacusStella	Unclustered
Lacy	Unclustered
Lad250	Unclustered
Ladasha	Unclustered
LaDeeDa	Unclustered
Lady	Unclustered
LadyandTramp	Unclustered
LadyBird	A2
Ladybug	Unclustered
LadyHelm	Unclustered
LadyMadonna	Unclustered
LadyMarah	Unclustered
LadyMaySilver	Unclustered
LadyPhaGa	A3
LaFlare	Unclustered
LaFoi	Unclustered
Lahaina	Unclustered
Lahmajoon	Unclustered
Lahoosier	Unclustered
Lakemo2013	None
Lakiya	Unclustered
Lala	Unclustered
Lambert1	Unclustered
LAMES	Unclustered
Lamina13	A1
Landa	Unclustered
Landshark	Unclustered
Langerak	Unclustered
Langsamer	Unclustered
Lanta	Unclustered
Laquisha	Unclustered
Larenn	A2
Larissa	Unclustered
Laroc	Unclustered
Larry	Unclustered
Lars	Unclustered
Larva	K5
Lassie	Unclustered
Lasso	B1
Lateralus	Unclustered
Laura	Unclustered
Laura302	Unclustered
Laurena	Unclustered
LaurenKim	Unclustered
Laurie	B2
Lawnmower	Unclustered
Lawrence	Unclustered
Lawson	Unclustered
LayzerBeam	Unclustered
Lazarus	Unclustered
LBuddy	Unclustered
Leafmealone	Unclustered
Leakylemmy	Unclustered
Leanne	Unclustered
LeapingLizzy	B4
LeBron	L1
LeeLot	B1
Lefty	K1
Legend	Unclustered
Legion	B1
Lego3393	B1
Legolas	B1
Leiah	Unclustered
Leigh	Unclustered
Lemon	Unclustered
LeMond	Unclustered
Lemondrop	Unclustered
LemonSlice	B1
Lemur	A4
Lenny	Unclustered
Lenox	Unclustered
Leo13	Unclustered
Leo43	Unclustered
Leonardo	Unclustered
Leonidas	Unclustered
LeonidasPrime	Unclustered
Leonidus	Unclustered
Leopold	Unclustered
Leperchaun	Unclustered
LePew	Unclustered
LePhoenix	Unclustered
LePhuge29	Unclustered
LeroyJenkins	Unclustered
Lesane	Unclustered
LeScholastica	Unclustered
Lesedi	A1
Lesgirvals	Unclustered
Leston	K5
LetsGetWeird	Unclustered
Lettuce	Unclustered
Lev2	A5
Leviathan	Unclustered
Levo	Unclustered
Lew	Unclustered
Lewis007	Unclustered
Lexi	Unclustered
Lexipuff	Unclustered
LHTSCC	A4
LIA1	G
Liam	Unclustered
Libby	Unclustered
Liberi	Unclustered
Libido	Unclustered
Lich	Unclustered
Licorice	Unclustered
Liefie	G
Lienemann11	Unclustered
Lifesaver	Unclustered
Lightyear	Unclustered
Lilac	E
LilaGirl	None
LilB	Unclustered
Lilbear	Unclustered
Lilbit	Unclustered
LilBjork	Unclustered
LilBub	Unclustered
Lilbugger	Unclustered
LilCaesar	Unclustered
LilDavid	Unclustered
LilFoot	Unclustered
LilFriend	Unclustered
LilGuy	Unclustered
Lilith	A3
LilJ	Unclustered
LilJanie	Unclustered
Liljon	Unclustered
Lillian	Unclustered
Lillie	Unclustered
Lilliputian	Unclustered
LillKim	Unclustered
Lilly	Unclustered
LilNugget	Unclustered
Lilo	Unclustered
LilRascals	Unclustered
LilRitchie	Unclustered
LilStanley	Unclustered
LilTrunchbull	Unclustered
Lilux	Unclustered
LilVlad	Unclustered
Lily	Unclustered
Lily1	Unclustered
Limbeezy3	A4
Limerricks	Unclustered
Linabeaar	Unclustered
Lincaica11	A2
Linda26	Unclustered
Lindsay7	Unclustered
Linguini	Unclustered
LinhQuyen	Unclustered
LinStu	C1
Lintanator	Unclustered
Linus3	Unclustered
LinusApple	Unclustered
Lito	P
Little3c	Unclustered
Littlebear	Unclustered
LittleCherry	A5
LittleDoug	Unclustered
LittleDude	None
LittleE	J
Littleengine	B3
LittleEngineer	Unclustered
Littlefoot	Unclustered
Littlefoot32	A1
LittleGreg	Unclustered
LittleGuy	A4
LittleKing	Unclustered
LittleLaurelle	Unclustered
Littleman	Unclustered
LittleMonster	Unclustered
LittleSea	Unclustered
Littleshow	Unclustered
LittleSparta	Unclustered
LittleSpot	None
Littleton	C1
Littleturtle	Unclustered
Littlewings	Unclustered
Liveshot	Unclustered
Lixy	Unclustered
LizLemon	B2
Lizzie	Unclustered
Llama	F1
Llij	F1
Lloyd	Unclustered
LmHap	Unclustered
Loadrie	L2
Lobo	Unclustered
Lobster	Unclustered
LochMonster	Unclustered
LochNess	Unclustered
Lockley	A1
Lockport	Unclustered
LockwoodMonsta	Unclustered
Locust	Unclustered
Lohikaarme	Unclustered
Loki	Unclustered
Lokis	Unclustered
Lolgummy	Unclustered
Lolli	Unclustered
Lolli48	Unclustered
LolliLolli	Unclustered
Lollipop	Unclustered
Lollipop1	Unclustered
Lollipop2	Unclustered
Lolly9	L3
Lollypop	Unclustered
LoLo	Unclustered
LoMein	Unclustered
Longbottom	Unclustered
LongIsland	Unclustered
Longo28	Unclustered
Longtail	Unclustered
Longtail44	Unclustered
Lonnie	Unclustered
Lonny	Unclustered
Loom	Unclustered
Loon	Unclustered
Loptob1	Unclustered
Loptob2	Unclustered
LordByron	Unclustered
LordFarquad	Unclustered
LordNelson	Unclustered
Lorenzoveg	Unclustered
Loser	A2
Loserface	Unclustered
Lost	Unclustered
Lost5eva	Unclustered
Lottie	Unclustered
Louie	Unclustered
Louie6	Unclustered
Louis	Unclustered
Louise	Unclustered
LouLou7	Unclustered
Louxcil	Unclustered
Loveless	Unclustered
LoversLane	Unclustered
Lowlife	Unclustered
Loxley	Unclustered
Loz67	Unclustered
LRRHood	C1
Lspd	Unclustered
Luce	Unclustered
Luchador	A2
Luci	Unclustered
LucidLucille6	Unclustered
Lucifer	Unclustered
Lucius	Unclustered
Lucky	Unclustered
Lucky1	Unclustered
Lucky13	Unclustered
Lucky2	Unclustered
Lucky2013	J
Luckyseven77	Unclustered
LuckySquared	Unclustered
LuckyStranger	Unclustered
Lucy916	Unclustered
LucyGoose	A4
Ludicrea	Unclustered
Ludificor	Unclustered
Luftballon	Unclustered
Lugosi	Unclustered
LugYA	Unclustered
Luigi	Unclustered
Luke117	Unclustered
LukeWaltzer	Unclustered
Lukie	Unclustered
Lulino	Unclustered
Lullipopitis	Unclustered
Lulu	Unclustered
Lulu03	Unclustered
Lulu12	Unclustered
Lumizar	Unclustered
Lumos	L3
Luna	Unclustered
Lunabelle	Unclustered
LunarEclipse	Unclustered
Luokhaos	Unclustered
Lupin	Unclustered
Luxanna	Unclustered
Luxflowers	Unclustered
LuzCuddles	Unclustered
Lwagugu	Unclustered
Lygiani	Unclustered
Lyla	Unclustered
Lyndzie	Unclustered
Lynx	Unclustered
Lyric	Unclustered
Lysh	Unclustered
Lysinator	F1
Lysocool	C1
Lysolibra	Unclustered
Mabelline	Unclustered
Macaco	Unclustered
Macaron	Unclustered
Macbeth	Unclustered
MacC	Unclustered
Maccar	Unclustered
Maccman	Unclustered
Machaera	A8
Machin	Unclustered
MacK	Unclustered
Mack10	Unclustered
MackAttack	Unclustered
MackieJ1	Unclustered
MackMack	Unclustered
MacnCheese	K3
Macula	Unclustered
MadamMonkfish	E
Maddox	Unclustered
Maderas	Unclustered
MadEye	Unclustered
Madhatter	Unclustered
Madison	Unclustered
Madruga	U
Mafu	Unclustered
Mag09	Unclustered
Mage	None
Maggie12	Unclustered
MaggieLaFox	Unclustered
Maggilopolus	Unclustered
Magnito	A1
Magnolia	Unclustered
MagnusMa	Unclustered
Magoo	E
Mahalo	Unclustered
Mahogany	Unclustered
Maidenhair	Unclustered
Mailbox	Unclustered
Mailey	Unclustered
Mainiac	A3
MaiyoF	Unclustered
Majekodunmi	Unclustered
MajorMinor	Unclustered
Mako	Unclustered
Makridi	Unclustered
Malbo	Unclustered
Malc	Unclustered
Malinsilva	A3
Malithi	P
Malkin71	B1
Mallen	Unclustered
Mallory	Unclustered
Malusi	Unclustered
Mama	Unclustered
MamaJanJan	Unclustered
Mammoth	Unclustered
Mana	B1
Manad	B1
Manage	Unclustered
Manaolana	Unclustered
Manatee	A1
Manda	Unclustered
Mandalore	Unclustered
MandM	Unclustered
Mangiatore14	Unclustered
Mangix	Unclustered
Mango	Unclustered
Mangueraloca	Unclustered
Manifest	None
Manifold	Unclustered
Mannie	Unclustered
MannyP	Unclustered
Mantequilla	Unclustered
Mantra	F1
Maple	Unclustered
Maple2	Unclustered
Maraca	Unclustered
Marble	Unclustered
Marcel	Unclustered
Marcell	A1
Marcum	Unclustered
MarcusBrown	T
Margarita	Unclustered
Margina	Unclustered
Margo	Unclustered
Maria	Unclustered
MariaHoutariRo	Unclustered
Marie	A3
Mario	Unclustered
Marion	Unclustered
Marklar	Unclustered
MarkPhew	Unclustered
MarlaGrill	Unclustered
Marlex	None
Marley	Unclustered
MarleyHill	Unclustered
Marmalade	Unclustered
Marmarsu	Unclustered
Marnawalay	Unclustered
Marnie	Unclustered
Maroc7	A1
MarQuardt	A3
Marsha	Unclustered
Marshall	Unclustered
Marshawn	Unclustered
Marshmallow	Unclustered
Martian	Unclustered
Martini	Unclustered
Martinka	Unclustered
Marty	Unclustered
Martyr	Unclustered
Marvin	S
Mary	Unclustered
MaryB	Unclustered
MaryBeth	Unclustered
MaryJ	Unclustered
MaryJane	Unclustered
MarzComet	Unclustered
MASH	Unclustered
Masha1295	A2
Mason	Unclustered
Mason1114	A1
Massacre	A4
Massud	Unclustered
Master2000	Unclustered
MasterPepe	Unclustered
Matilda	Unclustered
Matka	Unclustered
Matt	Unclustered
Matthew	Unclustered
Matthews	Unclustered
MattSC	Unclustered
Maury	E
Maverick	A4
Mavis	Unclustered
Mavro	Unclustered
Maximus	Unclustered
Maximus9x	Unclustered
Maxwell	Unclustered
Maxy	Unclustered
Mbanjwa	Unclustered
MBHunter	Unclustered
Mbroughton	Unclustered
McAwesome	Unclustered
McBrightitis	Unclustered
McCrawley	Unclustered
McCringleberry	Unclustered
McDave	Unclustered
McDiddy	F1
McFly	A6
McGuire	A1
McKayla93	Unclustered
McKenty	Unclustered
McKenzie	Unclustered
McKinnon95	None
McLovin	Unclustered
McMan1	Unclustered
McNair34	Unclustered
MCNugget	Unclustered
McRatchet	Unclustered
McTre	Unclustered
McTrio	Unclustered
Measels	Unclustered
Meatball	Unclustered
Medic	Unclustered
Medusa	A4
Meebla	Unclustered
Meefy	Unclustered
Meeko	E
MeeZee	A4
Megatron	B1
MeghanFocks	Unclustered
Meindertsma	Unclustered
Meister	Unclustered
MelbyJuel	Unclustered
Meliki	Unclustered
Melj	Unclustered
Mellz	Unclustered
Melo	Unclustered
Melody	Unclustered
Melpomini	C1
Melville	Unclustered
Melvin	A4
Melvin3	Unclustered
MEM1124	Unclustered
Mendel	Unclustered
Mendokysei	T
Menehune	Unclustered
Menhit	Unclustered
Menthos	Unclustered
MePac	C1
Meraxes	None
Mercurial	Unclustered
Meredith	Unclustered
Merica	Unclustered
MeriMarzia	Unclustered
Merio	Unclustered
MerionMan	Unclustered
MermaidH	Unclustered
Merp	Unclustered
Meru	Unclustered
Mesches	Unclustered
Mesh1	Unclustered
Mesquite309	Unclustered
Messi	Unclustered
MetalQZJ	A1
Metamorphosis	Unclustered
Methuselah	A3
Mfitzy25	Unclustered
MH15REBEL	Unclustered
MiaZeal	J
MIBB	Unclustered
Mica	Unclustered
Michaelangelo	Unclustered
MichaelScotch	Unclustered
Michelangelo	Unclustered
MichelleMyBell	N
Michellengi	Unclustered
Micho	Unclustered
Mickey	Unclustered
MickeyD	Unclustered
MickieT	Unclustered
Micosoft	Unclustered
Microbean	Unclustered
Microfairlady	Unclustered
MicroMind	Unclustered
MicroMini	K1
Microninja	Unclustered
Microwolf	A3
Midas	Unclustered
Midas2	Unclustered
Midnight	Unclustered
Miejsce	Unclustered
MightyMorph	None
MightyQuinn	Unclustered
Migo94	Unclustered
Migz	Unclustered
Mike09	Unclustered
MikeLiesIn	C1
Mikenancilyn	Unclustered
Mikeska	Unclustered
Mikriplithari	Unclustered
Mikrovio	Unclustered
Milagro	Unclustered
Milan	Unclustered
Milania	Unclustered
MileyV2B	Unclustered
MilleniumForce	F1
Miller13	Unclustered
Milleragzigian	Unclustered
Millidweller	Unclustered
Millie	Unclustered
Millski	A4
Milly	K2
Milo	Unclustered
Milo1414	Unclustered
Milton	None
Mimado	Unclustered
Mimicat	A1
Mimilly93	Unclustered
Mimzaloppa	Unclustered
Minaj	Unclustered
Mindprobe	Unclustered
MinDum	Unclustered
Mindy	E
Minerva	J
Minicole	Unclustered
Minicooper	Unclustered
MiniME	Unclustered
Minimix	Unclustered
Minimus	Unclustered
Minion	A1
MinionDave	F1
Minionstribe	Unclustered
Minipoke	None
Minky	Unclustered
MINNET	Unclustered
Minnie	F1
Minori	Unclustered
MintChip	Unclustered
Minutilla	Unclustered
MinyT10	Unclustered
Mira	Unclustered
Miracle	Unclustered
MiRage	Unclustered
Miranda	Unclustered
Miratin	Unclustered
MirrorLake4	Unclustered
Misfit	Unclustered
Mishelina	Unclustered
Mishine	Unclustered
Misomonster	A3
MissJackson	Unclustered
MissPiggy	Unclustered
MISSy	E
MissyE	Unclustered
MisterCuddles	F1
Mistert4	B1
Misty	Unclustered
Mita	Unclustered
Mitchell	A8
MitKao	B1
Mittens	Unclustered
Mitzo	Unclustered
Miyolaylie	Unclustered
Miyran	Unclustered
Mizitis	Unclustered
MJ15	Unclustered
Mjolnir	Unclustered
MkaliMitinis3	L2
MLFalcon	Unclustered
MLouK	K1
MNhockey7	Unclustered
Modster	Unclustered
Moffat	Unclustered
Mofred	Unclustered
MOHrun	Unclustered
Mojo	Unclustered
MojoJoJo	Unclustered
MoKit826	Unclustered
Molechan	Unclustered
Mollibalie	Unclustered
Momo	C1
MoMoMixon	C1
Monet	Unclustered
Money1	Unclustered
Monica	Unclustered
Monique	Unclustered
MonkeyCheese	Unclustered
Mono	Unclustered
Monodon	Unclustered
Monster	Unclustered
Monster14	Unclustered
Monstore308	Unclustered
Montague	Unclustered
MonTana	Unclustered
Monticord	Unclustered
Monty	Unclustered
Mooch	Unclustered
Moola	Unclustered
Moollenium	Unclustered
MooMoo	Singleton
MoonCake	Unclustered
MOOREtheMARYer	G
Moose	Unclustered
Moose1	Unclustered
Morbach	B1
Morbagris	Unclustered
Morbus	Unclustered
Morgagni	Unclustered
Morgan	Unclustered
Morgendorffer	Unclustered
Morgenstern	Unclustered
Morgoth	Unclustered
Morgushi	B1
Mori	Unclustered
Moriarty	Unclustered
Morizzled23	C1
Morke	Unclustered
Moros	Unclustered
Morpher26	A4
Morpheus	Unclustered
Morrow	A4
Morty	B1
Mosaic	B1
Mosby	E
Moses	Unclustered
Mosey	Unclustered
Mosley	Unclustered
MosMoris	S
Moss13	Unclustered
Mossy	Unclustered
Mossycloud	Unclustered
MossyNSankoh	Unclustered
MossyRotty	Unclustered
Moter17	A1
Mothersrugby	Unclustered
Motivation	Unclustered
Motley	Unclustered
MountainDerp	Unclustered
Mover02	Unclustered
Mower	Unclustered
Mowgli	G
Moxie	Unclustered
MoxieOC	Unclustered
Moxley	Unclustered
Mozart	Unclustered
Mozingo	K1
Mozy	F1
Mpat	Unclustered
MPlant7149	A1
MRabcd	B1
MrAggressive	Unclustered
MRAZ	Unclustered
MrBarnaby	A2
Mrbojangles	Unclustered
MrBubZ	Unclustered
MrClearer	Unclustered
MrCuddles	Unclustered
MrDifficult	Unclustered
MrGordo	A1
MrHyde	Unclustered
MrLongbottom	Unclustered
MrMud	Unclustered
MrRufusMan	Unclustered
MrSketchy	Unclustered
MrSpiffy	Unclustered
MrsSweetPotato	Unclustered
MrSwag	Unclustered
MsFluffums	Unclustered
MsLunaLoveBad	Unclustered
MSNyan	Unclustered
MSpok	Unclustered
MudBaby	Unclustered
Mudbug	Unclustered
Muddy	Singleton
Mudkip	Unclustered
Mudmonster	Unclustered
Mufasa	K2
Muffy	Unclustered
Mulatasaur	Unclustered
Mulch	H2
MulchExplorer	Unclustered
Mulciber	A11
Mule	A1
Mulligan2	Unclustered
MultiD	Unclustered
Munchie	Unclustered
Munchkin	Unclustered
Munchy	Unclustered
Mundrea	A4
Muphaffle	Unclustered
Murdoc	B1
Murdock7	Unclustered
Murica	E
Murphy	E
Murray66	Unclustered
Murucutumbu	K1
Museum	A1
Mushu	Unclustered
Mustache	Unclustered
Mustafa1	Unclustered
Mutaforma13	F1
Muus	None
Muzik	Unclustered
Mybelle	Unclustered
Mycroft	Unclustered
Mylitletria	Unclustered
Mylla	Unclustered
MyOTP	Unclustered
Myp9096	Unclustered
MyPolly1	Unclustered
MyPolly2	Unclustered
MyPrecious	Unclustered
Myrna	C2
Mysophobia	Unclustered
Mystery313	Unclustered
Mystique	Unclustered
Myxus	A9
Mzwa	Unclustered
Naca	A5
Nacho	B1
Nadia	Unclustered
NAFY	Unclustered
Nagapie	Unclustered
Nagi	Unclustered
NahDatSmall	Unclustered
Naij	Unclustered
NakedCat	Unclustered
NakedMoleRat	Unclustered
Nakoi	None
Nala	E
Nalphy	Unclustered
Nancy	Unclustered
NancyDrew	Unclustered
Nancylopicus	Unclustered
Nanospecial	Unclustered
NanoStealth	Unclustered
Nanuq	Unclustered
Napoleon	Unclustered
NapoleonDz	Unclustered
Nappy	C1
Naranjo	Unclustered
Narbals	Unclustered
Narcissus	Unclustered
Nargle	Unclustered
Narnar	Unclustered
Narwhal	Unclustered
Naslaataawi	Unclustered
Nastio	Unclustered
Natalie	Unclustered
Nate	Unclustered
Natica	Unclustered
Natosaleda	Unclustered
Natty	Unclustered
Natural20	Unclustered
Nauset	Unclustered
Nautilus	Unclustered
Nautilus1	Unclustered
Naveenium	Unclustered
Navi	Unclustered
Naytron3000	Unclustered
Nazo	Unclustered
Nblprz	Unclustered
NDBlanc	Unclustered
Ndlove	Unclustered
Ndoh15	Unclustered
NDrop100	Unclustered
Nebkcis	Unclustered
Nebs	Unclustered
Nebula	Unclustered
Necromancer	Unclustered
Nedd	Unclustered
NedStark	Unclustered
NelitzaMV	E
Nell61	Unclustered
Nemesis	Unclustered
Nemo	A2
Nemo1	Unclustered
Nemo2	Unclustered
Nemo3	Unclustered
Nepal	A1
Nephalae	Unclustered
Nephy	Unclustered
NeroInvictus	Unclustered
Neros	Unclustered
Nerujay	A1
Nessa	Unclustered
Nessack	Unclustered
Nessi	Unclustered
Nessie	Unclustered
Nessy	Unclustered
Nestitis	None
Neuwill	Unclustered
Neville007	Unclustered
Newman	B1
Nexus5	Unclustered
Ngelosi	Unclustered
NGobbelz	Unclustered
Nguta	Unclustered
Nhonho	A1
Nibb	Unclustered
Nice	Unclustered
Nicholasage	Unclustered
NicholasCage	Unclustered
Nicholasp3	L2
Nichols	Unclustered
Nick	Unclustered
Nickalodeon	Unclustered
NicLiz	Unclustered
NicLiz7	Unclustered
Nico	Unclustered
Nicoah	Unclustered
Nicolae	Unclustered
Nicolas	Unclustered
NicolasC	Unclustered
NicolasCagous	Unclustered
Nicolasphaqe	C1
Nicole	Unclustered
Niels	Unclustered
Nifemi	Unclustered
Nigel	B4
Nigelus	Unclustered
Nightingale	Unclustered
Nightshade	Unclustered
Nightwatch	Unclustered
Nikita	Unclustered
Nilo	R
Nimbus	Unclustered
Nimbus13	Unclustered
Nimbus2000	Unclustered
Ninetales	Unclustered
Ninja	Unclustered
Niren	Unclustered
Nishu	Unclustered
Nitora	Unclustered
Nitro112161	Unclustered
Nocturnal	Unclustered
Noggin	Unclustered
NoHalo	Unclustered
NOLA	Unclustered
Nola95	Unclustered
Nolan	Unclustered
Nolie	Unclustered
Nomad	Unclustered
NoMercy5	Singleton
Nomo	Unclustered
Noodle	F1
Noodle06	Unclustered
Noodlekat	Unclustered
Noodles	Unclustered
Noodles91	Unclustered
Noor	Unclustered
Nope	Unclustered
Nora	Unclustered
NoraZee	L2
Norbert	A3
Noremak	Unclustered
NormaGene	Unclustered
Normal	Unclustered
Norman	Unclustered
Norris	A2
Norris007	None
NorthernNL	Unclustered
Northpond	Unclustered
NorthStar	A4
Nosferatu	Unclustered
Nosin	Unclustered
NoSleep	E
Nosrednaski	Unclustered
NotBenAfleck	Unclustered
NoTBLeftBehind	Unclustered
Notch	Unclustered
NotEbola	Unclustered
NotPhail	Unclustered
NotTheCreek	Unclustered
Nova	D1
NovaAndreas	Unclustered
Novac	Unclustered
Novel	Unclustered
Novus	Unclustered
NovusOrsa08	Unclustered
Nowukno	Unclustered
Nqobile	Unclustered
Nsikan	Unclustered
Ntando	Unclustered
Ntobe	Unclustered
Nubbe	Unclustered
Nubilus	None
NuevoMundo	C1
Nugget	Unclustered
Nugget92	Unclustered
Nuke	Unclustered
NumberOneBP	Unclustered
Numberten	B1
NumeroOcho	Unclustered
Nuria	Unclustered
Nurky	Unclustered
Nutello	Unclustered
Nutmeg	Unclustered
NyackWarriors	Unclustered
Nylara	Unclustered
NYQC	Unclustered
Nyxis	A4
Oaker	H1
OakieDokie	Unclustered
Oakley	Unclustered
Obama	Unclustered
Obama12	A4
Obama319	None
Obdachlus	Unclustered
Obeezy	E
Obiwan	Unclustered
Obliterator	Unclustered
OBUpride	Q
Occulta	Unclustered
Ocelot	Unclustered
Octavaria	Unclustered
Odd50	Unclustered
Odds22	Unclustered
Odilo	Unclustered
Odin	A2
Odysseus	Unclustered
OfficersClub	Unclustered
Ogopogo	F1
Ogun	Unclustered
Ohno789	Unclustered
Oink	Unclustered
Oke85	Unclustered
OkiRoe	K5
Olaf	Unclustered
OlanP	Unclustered
OldTimer	Unclustered
Oline	B1
Olive	Unclustered
Olive00	None
Oliver	Unclustered
Oliver2	Unclustered
OliverWalter	B1
Olli	Unclustered
Ollie	A3
Oluwafunmilayo	Unclustered
Olympia	Unclustered
OlympiaSaint	F1
Omee	Unclustered
Omega	J
Omicron	Unclustered
Omnicron	K5
Omnomnom	Unclustered
ONeill	Unclustered
OneUnkwnBug	E
Onion	Unclustered
Onixilius	Unclustered
Onyx	Unclustered
OodleNoodle	Unclustered
Oogway	Unclustered
Oops	Unclustered
Oosterbaan	B1
Opalius	Unclustered
Ophelia	Unclustered
Ophil09	Unclustered
Ophiuchus	Unclustered
Optimus	J
OptimusPrime	Unclustered
OptimusSAfrica	Unclustered
OptimusTribe	Unclustered
OrangeDuck	Unclustered
OrangeJulius	Unclustered
OrangeOswald	B3
Orbit	Unclustered
Orby	Unclustered
Oreo	Unclustered
OreoRat	Unclustered
Orion	B1
OrionPax	E
Orocovis	Unclustered
Orpheus	Unclustered
Osa7	Unclustered
Oscar	Unclustered
OSmaximus	B1
Ossie	Unclustered
Ostojic	A3
Ostrich	Unclustered
Oswald	Unclustered
Oswaldo	Unclustered
Otracosa	Unclustered
Otterteeth	Unclustered
Ousia	None
Outrageous	Unclustered
Ovechkin	F1
OVickCalE14	Unclustered
Ovington32	Unclustered
Owens0204	Unclustered
OwlsT2W	F1
Oxente	A1
Oyez	Unclustered
Ozzello	Unclustered
Ozzieduffburn	Unclustered
P28Green	A3
Pablo	None
Pacc40	F1
Pacco	Unclustered
PacerPaul	Unclustered
Pacha	Unclustered
PackMan	A9
Paco	Unclustered
Pacos19	B1
Padfoot	Unclustered
PagoAzul	Unclustered
Paige	Unclustered
PaigeLNB	Unclustered
Palestino	A4
Paliothales9	B4
Pallavicini	None
Palmmer	Unclustered
Palo	Unclustered
Pamplemousse	Unclustered
Panamaxus	A3
Pancake	Unclustered
Panchino	N
Panda1	Unclustered
Panda2	Unclustered
Panda3	Unclustered
Pandacub1110	Unclustered
PandaKarenina	Unclustered
Pandorae	Unclustered
Pansy	Unclustered
Pantalones	Unclustered
Panther	Unclustered
PapaSmurf	Unclustered
Papazi	Unclustered
Paper	A6
Papez	A1
Pappalavio	Unclustered
Papyrus	R
Paradise	Unclustered
Pari	A1
Parish	Unclustered
Park2400	Unclustered
Parker	Unclustered
ParkerPond	Unclustered
Parks1	A1
Parliament	Unclustered
ParrMAF	Unclustered
ParumDeTerra	Unclustered
Parvamundi	Unclustered
Pascack	Unclustered
Pat26	Unclustered
Patch	C1
Patience	U
Patina	Unclustered
Patricia	Unclustered
Patriot	Unclustered
Patronus	Unclustered
Patronus1	Unclustered
PattyP	A1
Paul	Unclustered
PaulusMaximus	Unclustered
Pavarotti	Unclustered
Pavlova	Unclustered
PBI1	D1
Pbnep65	None
PCassDorin	Unclustered
PCoBaH	Unclustered
PDonaz	None
PDRPiii	Unclustered
PDRPiv	Unclustered
PDRPix	Unclustered
PDRPv	Unclustered
PDRPvi	Unclustered
PDRPvii	Unclustered
PDRPviii	Unclustered
PDRPx	Unclustered
PDRPxi	Unclustered
PDRPxii	Unclustered
PDRPxiii	Unclustered
PDRPxiv	Unclustered
Peaches	A4
Peanut	Unclustered
PeanutandJelly	Unclustered
Peanuthands	Unclustered
Pearbear	Unclustered
Pearl	Unclustered
Pearson2313	Unclustered
Peaty	Unclustered
PebactiLay	Unclustered
Pebbles	Unclustered
Peel	Unclustered
Peeves	Unclustered
PeeWee	None
Peeza	Unclustered
Pegasus	Unclustered
Pegasus5	Unclustered
PegLeg	M1
Pele	Unclustered
Pemerex	Unclustered
Pendragon	Unclustered
Pendulum	Unclustered
Penelope	Unclustered
Penguin	Unclustered
Penguin23	Unclustered
Penny	Unclustered
Penny1	None
Penny144	Unclustered
Pentatonic	Unclustered
Peony	Unclustered
Pepe	A1
Pepper	Unclustered
PepperEW	Unclustered
Pepprock	Unclustered
Pequin	Unclustered
Periwinkle	Unclustered
PerkinsPharm	Unclustered
Perry	Unclustered
PerscriptonBug	Unclustered
Perseid	Unclustered
Persephone	K2
Perserverance	Unclustered
Perseus	A1
Persnickety	Unclustered
Peru	Unclustered
Peskyles	Unclustered
Pest	Unclustered
Pestave2	Unclustered
Pestilence	Unclustered
Pete	Unclustered
Peterlinda	Unclustered
PeterPan	Unclustered
PeterPeter	A4
Peterson	Unclustered
PetitChou	Unclustered
Petp2012	A1
Petra64142	Unclustered
Petrichor	Unclustered
Petruchio	A1
Petrus	Unclustered
Petruvias	R
Petunia	Unclustered
PFelix9	Unclustered
Pferdehirt	Unclustered
Pfunkadelic	Unclustered
PG1	B1
PH9000	Unclustered
Phaaron	Unclustered
Phab	Unclustered
Phabba	Unclustered
Phabelincoln	Unclustered
Phabio	F1
Phable	Unclustered
Phabrizio	Unclustered
Phabulous	Unclustered
Phacado	A4
PHAco	Unclustered
Phactorial	Unclustered
Phae	Unclustered
Phaedra	None
Phaedrus	B3
Phaetashen	Unclustered
Phagalicious	Unclustered
Phagilicious	Unclustered
Phaginstein	Unclustered
Phaguccine	None
Phagyonce	Unclustered
Phail	Unclustered
Phaithful	Unclustered
Phaja	E
Phalaphel	Unclustered
Phallucination	Unclustered
Phamished	B1
Phancy	Unclustered
Phangelica	Unclustered
Phanphagia	Unclustered
Phantasmic	Unclustered
Phantastic	A3
Phantom	Unclustered
Pharaon	Unclustered
Pharcinate	Unclustered
Pharsalus	E
Phaslett	Unclustered
PhassiveAggro	Unclustered
PhatBacter	E
PhatCats2014	Unclustered
Phate	Unclustered
Phatea	Unclustered
Phatniss	F1
Phatrick	Unclustered
Phatty	Unclustered
Phatzo	Unclustered
Phaux	E
PhayneMcCulloh	Unclustered
Phayonce	P
PheadyHage	Unclustered
Pheception	Unclustered
Pheezus	Unclustered
Pheezyfbaby	Unclustered
Phelemich	B5
Phelipe	Unclustered
Phelix	Unclustered
Phelps	Unclustered
Pheminist	Unclustered
Phemity	Unclustered
Phenrir	Unclustered
Phenway	Unclustered
Pherb	Unclustered
Pherdinand	Unclustered
Phergalicious	Unclustered
Pherris	Unclustered
Phestive	Unclustered
Phetacheez	Unclustered
Phetus	Unclustered
Phfriend	Unclustered
Phickle	Unclustered
Phido	Unclustered
Phiesta	Unclustered
PhiggyFeeGee	Unclustered
Phighter1804	A4
Phignatius	Unclustered
Phil	Unclustered
Philbert	Unclustered
Philip	Unclustered
Philliam	Unclustered
Phillip	Unclustered
Phillippe	Unclustered
Philus	Unclustered
Phinally117	Unclustered
Phinci	Unclustered
Phineas	P
Phineas3776	K1
Phinicky	Unclustered
Phinn	Unclustered
Phiona	Unclustered
Phipp	Unclustered
Phipps	B1
PhishRPhriends	Unclustered
Phlagler	Unclustered
PhlakaPhlame	Unclustered
Phlakey	Unclustered
Phlavio	Unclustered
Phlawless	Unclustered
Phlei	A13
Phlorence	A5
Phlox	Unclustered
Phlyer	B3
Phlynn	None
Phobos	Unclustered
Phoebe	Unclustered
Phoenix	Unclustered
Phoenix924	Unclustered
Phoenixian115	Unclustered
Phondacks	Unclustered
Phontbonne	Unclustered
Phorensics	Unclustered
Phoxy	A3
Phrancis	Unclustered
Phrank	Unclustered
Phrankie	Unclustered
Phranklin	Unclustered
PhrankthaTank	F1
Phrann	Unclustered
Phreak	G
Phredbird	Unclustered
Phrenchphry	Unclustered
Phrodo	Unclustered
PhrostyMug	A1
Phrux	E
Phudgey	Unclustered
Phugeddaboudit	Unclustered
Phumi	Unclustered
Phundamental	Unclustered
Phung	None
Phusco	Unclustered
Phyllis	None
Phynx	Unclustered
Pia13	Unclustered
Piccolo	Unclustered
Piccolo9	Unclustered
Pickle	Unclustered
Pickrel13	B1
PicktownAL	Unclustered
Piedle3	Unclustered
Pier	C1
Pierogie	Unclustered
Pierre	Unclustered
Pierre1886	Unclustered
Piglet	B1
PigLet2	Unclustered
Pigpen	Unclustered
Pigwidgeon	Unclustered
Pikachu	Unclustered
Pikaphi	Unclustered
Pindia	Unclustered
Pineapple	Unclustered
Ping	Unclustered
Pinj	Unclustered
Pink	Unclustered
PinkDagger	Unclustered
PinkEros	Unclustered
Pinkerton	Unclustered
PinkLady16	B1
PinkPlastic	Unclustered
PinkRainbow	Unclustered
PinkRaptor	Unclustered
Pinkstatic	Unclustered
PinkUnicorn	Unclustered
Pinky	Unclustered
Pinnacle55	Unclustered
Pinnie	Unclustered
Pinpoint	Unclustered
Pinpricks	Unclustered
Pinto	A1
Pio	C1
Pioneer	A9
Pipcraft	A4
Pipefish	B3
Pippin	Unclustered
Pippy	F1
Pipsqueak	B1
Pipsqueaks	N
PipsqueakWM	Unclustered
Pirahaku	Unclustered
Piro94	A2
Pirrup	Unclustered
Pita	Unclustered
PITA1	Unclustered
Pitoo	Unclustered
Pixie	K3
PixieRose	Unclustered
Pizzicato	Unclustered
Plackberry	F1
Plagueis	Unclustered
Plakstreakboy	Unclustered
Plaqccine	None
Plaqniss	Unclustered
PlaqsimusPrime	Unclustered
PlaqueandDans	Unclustered
PlaquePearl	Unclustered
Platypus	Unclustered
Plavalaguna	Unclustered
PlayDoh	Unclustered
Pleione	C1
Pleonasm	Unclustered
Plinko	Unclustered
Pliny	Unclustered
PLot	D1
Pluffbarre	Unclustered
Pluffmud	Unclustered
Plumberjoe	Unclustered
PlumJV0801	Unclustered
Pluto	Unclustered
PlutonisFilius	Unclustered
PMaximus	Unclustered
PMC	F1
Pocahontas	A3
Pocha	Unclustered
Pocky	Unclustered
Podd	Unclustered
Poffad	Unclustered
Poga	Unclustered
Poindexter	Unclustered
Pokerus	Unclustered
Pokie	Unclustered
Polaris	Unclustered
Polfin	Unclustered
Polise	Unclustered
Polish	Unclustered
Polka14	F1
Polkadot	Unclustered
Polliwog	Unclustered
Pollo	Unclustered
Polygamy	Unclustered
Polymorphads	Unclustered
Pond	Unclustered
Pondboy	Unclustered
Ponteberry	Unclustered
Ponyo	Unclustered
Ponytail	Unclustered
Poochlock	None
Pooka94	Unclustered
Pootina	Unclustered
Pop23	Unclustered
Pop9	Unclustered
Popcicle	A3
Popcorn	Unclustered
Popkavich	Unclustered
Poppet	Unclustered
Poppop	Unclustered
Poppy	Unclustered
Pops	B1
Porkchop	Unclustered
Porky	E
Porter	Unclustered
Porto	Unclustered
Poseidon	Unclustered
Poseidoness	Unclustered
Possum	Unclustered
Postal	Unclustered
Postcard	Unclustered
Postea	Unclustered
Potato	Unclustered
PotatoSplit	A3
Poto4B	Unclustered
Potter	B1
Poudyal	Unclustered
Pound	J
Power	A2
Poxx	Unclustered
Praegressus	Unclustered
Praetorian	Unclustered
Pratna	Unclustered
Precious	Unclustered
Predator	H1
Preeshyadeit	Unclustered
Pregunta	Unclustered
PrescriptonBug	Unclustered
PRex	Unclustered
Prez6	Unclustered
Pride517	Unclustered
PrimeDEK	Unclustered
Primetime	Unclustered
Primo	Unclustered
Princess	Unclustered
Princess13	Unclustered
PrincessAnna	Unclustered
PrincessAurora	Unclustered
PrincessBaHa	Unclustered
PrincessPhilip	Unclustered
PrincessPhiona	Unclustered
PriTime	Unclustered
Problematic	Unclustered
ProblemChild	Unclustered
Process12	Unclustered
ProfessorChaos	Unclustered
ProfessorX	Unclustered
ProfMoriarty	Unclustered
Prometheus	F1
Promisqua	Unclustered
Protean	Unclustered
Proteus	Unclustered
Pruitto	Unclustered
Pseudonym	Unclustered
Psyche	Unclustered
PsycoClown	Unclustered
Puck	None
PuckSorge	Unclustered
PuddinPop	Unclustered
Puddles	Unclustered
Pudge	Unclustered
Puff	Unclustered
Puhltonio	B1
Pukovnik	A2
Pumato	Unclustered
Pumbaa	Unclustered
Pumpkin	E
PunkHazard	Unclustered
Punser	Unclustered
PuraVida	B1
Purivida	Unclustered
Purkiss	Unclustered
Purky	P
PurpleHaze	A3
PushkinA	Unclustered
Putin	Unclustered
Pwombat	None
Pylie	Unclustered
Python	Unclustered
Qalhata	Unclustered
QBert	C1
Qetsiyah	Unclustered
Quados	Unclustered
Quagmire	Unclustered
Quasha	Unclustered
Que145	Unclustered
Queen	Unclustered
QueenB	Unclustered
QueenBee	Unclustered
QueenBey	Unclustered
QueenBP	Unclustered
QueenElizabeth	Unclustered
QueenIndie	Unclustered
Queso	Unclustered
Queue	Unclustered
Queya	Unclustered
Quico	F1
Quin	Unclustered
Quincy	Unclustered
Quink	E
QuinnKiro	A3
Qute	Unclustered
Qwerty	Unclustered
Qyrzula	B2
R0ndNuag3	Unclustered
Rabin276	Unclustered
Rabrifago	Unclustered
Raby	Unclustered
Rachel	Unclustered
Racso	Unclustered
Radagast	Unclustered
RadDad	Unclustered
Raddie	Unclustered
Raditz	Unclustered
Rae2	Unclustered
Rafa	Unclustered
Rafaello	Unclustered
Rafb01	Unclustered
Rafe	Unclustered
Rafiki	Unclustered
Rafikki	Unclustered
RafLauren	Unclustered
RAGE	Unclustered
Rage18	Unclustered
RageTheFage	Unclustered
Ragnar	Unclustered
Ragnarok	Unclustered
Ragtime	Unclustered
Rahalelujah	Unclustered
Raichu	Unclustered
Raider	Unclustered
Rain	Unclustered
Rainbow	Unclustered
Rainey	Unclustered
Raisin	Unclustered
Raja	Unclustered
Rajelicia	Unclustered
Rajititis	Unclustered
Rakim	E
Rallo	Unclustered
Ralpheria	Unclustered
Ralphie	Unclustered
RamAnn5	Unclustered
Rambo	Unclustered
Ramorosa	Unclustered
Ramses	Unclustered
Ramsey	F1
Ramy	Unclustered
Randee009	Unclustered
Rando14	Unclustered
Ranger	Unclustered
RangeRover	Unclustered
Rankashank	Unclustered
Raphael	Unclustered
Rapture	Unclustered
Rascal	Unclustered
Rascal246	Unclustered
Rashberry	Unclustered
Raskolnikov	Unclustered
Rasool	Unclustered
Raspberry	Unclustered
Ratasucia	Unclustered
Ratchet	Unclustered
RatIE	Unclustered
Rauana	A2
Ravage	Unclustered
Rawr	Unclustered
RayAllenIsGod	Unclustered
Raycer	Unclustered
Rayn	Unclustered
RayRay	Unclustered
Razgoosk7	Unclustered
RBurden	Unclustered
RCheetah	Unclustered
Reach	T
Realma	Unclustered
Reaper	Unclustered
Reaver	Unclustered
Rebeuca	A10
Reboot	Unclustered
RecPOLE	Unclustered
Redbud92	Unclustered
RedDragon	Unclustered
RedDwarf	Unclustered
Redi	N
Redkitties	Unclustered
Redninja	Unclustered
Redno2	J
RedQueen	Unclustered
RedRock	A2
RedRover	Unclustered
Redrum	Unclustered
Reepicheep	Unclustered
Reeses	Unclustered
Reeyant	Unclustered
Refentse	Unclustered
Refilwe	Unclustered
RegenaGeorge	Unclustered
Regg	Unclustered
Reggy	Unclustered
Regina	Unclustered
Reginald	Unclustered
Regis	Unclustered
Reisstrgt	Unclustered
Relyks	Unclustered
Rem711	Unclustered
Remembrance	Unclustered
Remi	Unclustered
Remington5	Unclustered
Remolla	Unclustered
Remy	Unclustered
Remyl	Unclustered
Renaud18	Unclustered
ReneeMass	Unclustered
Renegade	Unclustered
Reprobate	B5
Reptar	Unclustered
Requiem	Unclustered
Restless	Unclustered
Retriever	Unclustered
Retsirb	G
Revan	Unclustered
Revitiligo	Unclustered
Rex1	Unclustered
Rex2	Unclustered
Rexasaur2	E
RexleyOsius	Unclustered
Rey	M2
Rfink25	B1
Rgold55	Unclustered
RGThreeodore	Unclustered
Rhaegar18	Unclustered
Rhea	Unclustered
RheCon2012	Unclustered
Rhenz	Unclustered
Rhmpage50	Unclustered
Rhodalysa	Unclustered
Rhoker	Unclustered
RhynO	A10
Richard	Unclustered
RickJames	Unclustered
Riddle	Unclustered
RidgeCB	A1
Ridley	Unclustered
Rigby	Unclustered
Rigel	A1
RihCaTveit	Unclustered
RileyBeHungry	Unclustered
Rimmer	Unclustered
Ringer	A1
RingO	Unclustered
Ripley	Unclustered
Ripper	Unclustered
RirofearNZ	Unclustered
RiverMonster	E
RiverSong	Unclustered
Rivzn	Unclustered
Rizal	C1
Roachzilla	Unclustered
Roadbarry13	A3
Roary	A8
Robey12	Unclustered
RobinHood	Unclustered
RobM	Unclustered
Rocapsid	Unclustered
Rocket	Unclustered
Rocketman	Unclustered
Rockne	Unclustered
Rockstar	A3
Rocktrap	F1
Rockwell	E
Rocky	A1
RockyB	Unclustered
RockyHorror	F1
RockyII	Unclustered
RockyJD	Unclustered
Rodney	Unclustered
Roetering	None
RoflCopter	Unclustered
Roflstomp	Unclustered
Roger	Unclustered
Rogue	Unclustered
Rohr	Unclustered
RollingStone	Unclustered
RolliPolli	Unclustered
Rombolo	F1
Romulus	Unclustered
RonKinser	K3
RonRayGun	T
Roo22	Unclustered
Rorschach	Unclustered
Rory	Unclustered
Rosalind	Unclustered
Roscoe	B1
Rose1	Unclustered
Rose2	Unclustered
Rose308	Unclustered
Roseanne	Unclustered
Rosebud	Unclustered
Rosebush	B2
RoseLilly	None
Rosemary28	Unclustered
RosensternS2	Unclustered
Rosepeake4	Unclustered
Rosetta	Unclustered
Rosey	Unclustered
Roshambo	Unclustered
Rosie	Unclustered
Rosie13	Unclustered
Roslyn	Unclustered
Ross	Unclustered
Rosy	Unclustered
Roue	Unclustered
Rover	None
Rover14	G
Rovergator	Unclustered
Roxas	Unclustered
RoxB18	Unclustered
RoXIe16	Unclustered
ROXX	Unclustered
Roxy	Unclustered
RoyalFlush	Unclustered
RoyalPain	Unclustered
RoZara	Unclustered
Rozay	K1
Rrex	Unclustered
Rstan	B2
Rubeus	Unclustered
Rubi	Unclustered
Ruby	F1
Ruby2	Unclustered
RubyReddy	Unclustered
Ruckus	Unclustered
Rudolph	Unclustered
Rufilo	Unclustered
Rufio	Unclustered
Rufus	A1
Rugaru	Unclustered
Rum14	E
Rumex	Unclustered
Rump	Unclustered
Rumpelgeist	Unclustered
Rumpelstiltskin	L2
Runrun16	Unclustered
Runs	Unclustered
Ruoa	Unclustered
Ruotula	A1
Rupal	Unclustered
Rupert	Unclustered
Russell	Unclustered
Rutherferd	A1
Ruthiejr	Unclustered
Ruthy38	Unclustered
RyanO	Unclustered
RyuujiXTaiga	Unclustered
RZarchy	Unclustered
S2Kari	F1
S2Swirl	Unclustered
S2TSquared	F1
S523appy	Unclustered
Saal	F1
Sabertooth	A4
Sabia	A3
Sabinator	A3
SabLanka	Unclustered
Sabotage	None
Sadie	Unclustered
Sadisa	Unclustered
Saek	Unclustered
Sagamore	None
Sagar	Unclustered
Sagaritus	Unclustered
Sage	Unclustered
Sahi	Unclustered
Sahun	Unclustered
Saintus	A8
SaJo	Unclustered
Sakura	Unclustered
SallySue	Unclustered
SaltyMike	F1
Sam1	Unclustered
Sam2	Unclustered
SAMAG	Unclustered
Samarai	None
Samasafish	Unclustered
Samatron	Unclustered
SamCro	Unclustered
Samegan	Unclustered
Samfuze	Unclustered
Sammy	Unclustered
SamScheppers	K4
Samuall	Unclustered
SamuelLPlaqson	K1
Samurai	Unclustered
Samwise	Unclustered
Samypholo	Unclustered
Sana03	Unclustered
Sancho	Unclustered
Sanctus	Unclustered
Sandy	Unclustered
SandySoul24	Unclustered
Sangheili	Unclustered
Sanguine	Unclustered
SankungSillah	Unclustered
SantyClause	Unclustered
Sapphire	Unclustered
Sarah	Unclustered
SarahPhalin	Unclustered
Sarang	K1
Saratoga	Unclustered
Sarazen	Unclustered
Sarefi02	Unclustered
SarFire	A1
SargentShorty9	A1
Sarma624	Unclustered
Sasha	Unclustered
SaSk	Unclustered
Sasquatch	Unclustered
Sass13	Unclustered
Sassafras	Unclustered
Sassay	E
SassBadger	B3
Sassha110	Unclustered
Sassy	Unclustered
SassyB	Unclustered
SassySquirrel	Unclustered
Sauron	Unclustered
SavageLexi	Unclustered
Savanna	Unclustered
Savant	Unclustered
Savyy	Unclustered
Sayel	Unclustered
Saylavi	Unclustered
Sayuri	Unclustered
Saywy	Unclustered
Sbash	I2
Scally	Unclustered
Scallywag	Unclustered
Scamp	Unclustered
Scampy	Unclustered
Scar	Unclustered
Scarlett	None
Scarmiglione	Unclustered
ScarPhace	Unclustered
Schenley	Unclustered
Schmeganwinter	Unclustered
SchmegRyan	Unclustered
Schmidty	Unclustered
Schmoolie	Unclustered
Schmutz	K1
Schmyles	Unclustered
Schnapii	Unclustered
Scholastic218	Unclustered
Schultzie	Unclustered
Schwarz	Unclustered
Schwoop	Unclustered
Scinfaxi	Unclustered
Scooby	Unclustered
SCook24	Unclustered
Scoot17C	B1
Scooter	None
Scopus17	Unclustered
Scorpia	A5
Scorpio7	A2
Scorpion	Unclustered
ScottMcG	C1
ScottWPilgrim	Unclustered
Scout	Unclustered
Scowl	A1
Screwtape	Unclustered
ScubaSteve	Unclustered
ScubaTuba	Unclustered
Scylla	Unclustered
SDcharge11	B1
SDShaggy	Unclustered
Seabiscuit	A1
Seagreen	Unclustered
Seanderson	Unclustered
SeaPony	Unclustered
Sebastian	C1
Sebata	C1
Secretgarden	Unclustered
Sed2014	Unclustered
SeductivePerry	Unclustered
Seen11	Unclustered
Seer	Unclustered
Semfuze	Unclustered
SemperFi	A2
Sen4	Unclustered
Send513	R
Senketz	Unclustered
Serena	None
Serendipity	B1
Serendipity89	Unclustered
Serenity	A2
Serpentine	B1
Setmulbee	Unclustered
Sevare	Unclustered
Severus	A10
Sewage	Unclustered
SF1Gamma	A1
SF5Eta	A1
SG4	F1
SgtPepper	Unclustered
Sh3riff	Unclustered
Shaah	Unclustered
Shackle	Unclustered
Shadow	Unclustered
Shadow11	Unclustered
ShaDynasty	Unclustered
Shaemus	Unclustered
Shaggy	Unclustered
Shaka	A4
Shako	Unclustered
Shalonda	Unclustered
Shamloul	Unclustered
ShamWow	Unclustered
ShankPowerGod	C1
ShAnn44	Unclustered
Shannie	Unclustered
Shantee	Unclustered
Sharkbait	Unclustered
Sharknado	Unclustered
Sharpshooter	F1
Shauna1	F1
ShedlockHolmes	K3
Sheen	A7
Sheki	Unclustered
Sheldon	Unclustered
Sheldon2013	Unclustered
Sheldon2014	Unclustered
SheldonCooper	Unclustered
Shenzi	Unclustered
Sheplon	Unclustered
SherL	F1
Sherlock	Unclustered
Sherman	Unclustered
Sherri5110	Unclustered
Shetani	Unclustered
Shibby	Unclustered
Shibe	Unclustered
Shifty23	Unclustered
ShiLan	F1
Shings	Unclustered
Shinu	Unclustered
Shipshape	A2
Shipwreck	P
Shire	Unclustered
Shirley	Unclustered
ShirleyTemple	Unclustered
Shiva	Unclustered
ShiVal	B1
Shkim	Unclustered
Shmeggriffin	Unclustered
Shmellshmoll	Unclustered
Shmoo	Unclustered
Shmuel	Unclustered
Shnee	Unclustered
Shock	Unclustered
Shockage	Unclustered
Shockwing	Unclustered
ShoKaseMoney	Unclustered
Shootingstar	Unclustered
Shorbie	Unclustered
ShortStuff	Unclustered
Shouldaboii	Unclustered
Shreklove	Unclustered
Shrimp	C1
Shua	J
Sicario	Unclustered
Sicarius	Unclustered
Sidewinder	Unclustered
Sidney	Unclustered
Sidthesloth	Unclustered
Siege	Unclustered
Sigman	B1
Sigmund	Unclustered
Silas	Unclustered
SilentKiller	Unclustered
Sillygoose	Unclustered
Silona	Unclustered
Silvana	Unclustered
SilverBell	Unclustered
Silverdove	Unclustered
Simba	Unclustered
SimbaJr	Unclustered
Simon	Unclustered
Simpliphy	E
Sinestro	N
Sinner	Unclustered
Sinuous	Unclustered
SirDuracell	E
SirGardenPost	Unclustered
SirHarley	D1
Sirius	Unclustered
SiriusPlaque	Unclustered
SirJay	Unclustered
SirJohnDoe	Unclustered
SirLakeWood	Unclustered
SirPhilip	Unclustered
SirSheldon	Unclustered
Sirus	Unclustered
SirZoom	Unclustered
Sisco2014	Unclustered
SiSi	F1
Sisyphus	Unclustered
Sitala	Unclustered
Sixeladio	Unclustered
Skad	Unclustered
Skadi	Unclustered
SKANS	Unclustered
Skeeter	Unclustered
SKET	Unclustered
SkinnyMini	Unclustered
SkinnyPete	N
Skip	Unclustered
Skipitt	A4
SkiPole	A1
Skipper	Unclustered
Skogenitis	Unclustered
Skol39	Unclustered
Skpmule	None
Skrillex	Unclustered
Skruzzles	B4
SkyC	Unclustered
Skye	None
Skywalker	Unclustered
Slagathor	Unclustered
Slarp	K4
Slater	Unclustered
Sleigher	Unclustered
Slepnir	Unclustered
SlimJames	Unclustered
SlimJim	Unclustered
SlimShanky	Unclustered
Slimy	Unclustered
Slingshot	Unclustered
Slingshot10	Unclustered
Slinky	Unclustered
Sloth	Unclustered
Slowmo	Unclustered
Slowpoke	Unclustered
Slugama	Unclustered
Smairt	A1
Smalch3	Unclustered
SmallerPox	Unclustered
SmallFry	C1
Smallgem	Unclustered
Smalls	Unclustered
Smalls13	Unclustered
SmallSoldier	None
Smartypants	Unclustered
Smashbox	Unclustered
Smasher	Unclustered
Smeadley	A8
Smeagol	A1
Smeb	Unclustered
Smeegel	Unclustered
Smegermeister	Unclustered
Smidget	Unclustered
Smile	Unclustered
Smiles	Unclustered
Smiley	Unclustered
SmileyMyrus	Unclustered
Sminell	Unclustered
Smith	Unclustered
Smitten	Unclustered
Smog	Unclustered
Smokey	Unclustered
Smoky	Unclustered
Smooch	Unclustered
SmoothCriminal	Unclustered
Smoove40	Unclustered
Smsaah13	Unclustered
SnapBack	Unclustered
Snape	Unclustered
Snapplemona	Unclustered
SneakyTheDog	Unclustered
Sneeze	G
Snegatron	Unclustered
Snenia	Unclustered
Sniffy	Unclustered
SnookieMonster	Unclustered
Snoopy	Unclustered
Snooty	Unclustered
Snorlax	Unclustered
Snowflake	Unclustered
Snowkita	Unclustered
Snowman	Unclustered
SnowTiger	Unclustered
SnShneDyDrmJG	Unclustered
Snuffleupagus	Unclustered
SnuggleHeart	Unclustered
Snuggles	Unclustered
SoAngelic	Unclustered
Sob2010	Unclustered
Sochs	Unclustered
SoFetch13	Unclustered
SoilDragon	Unclustered
Sokana	Unclustered
Solaire	Unclustered
Solar	Unclustered
Solar36	Unclustered
Sole	Unclustered
SoletiStotinki	None
Solibear	Unclustered
SolitaireK	Unclustered
Solon	A1
SomethingCool	Unclustered
Somtia	Unclustered
Sonata	Unclustered
Sonic9	Unclustered
Sonlana	Unclustered
Soobryan	Unclustered
Sookie	Unclustered
SoonerLegend	Unclustered
Sophia	B1
Sophiage	Unclustered
Sophie	Unclustered
SophiesChoice	A4
Sophocles	Unclustered
Sophus	H1
Sorriso2	Unclustered
Sosa	Unclustered
Soto	B1
Sotrice96	E
SoupAstar	None
Sour25	Unclustered
SourDeemo	Unclustered
SourPatch	Unclustered
SouthernPearl	Unclustered
Southpaw	Unclustered
Sparagna	Unclustered
Spark	Unclustered
Sparkdehlily	F1
Sparkldeth	Unclustered
Sparkles	Unclustered
Sparkles111	Unclustered
Sparky	Singleton
Sparrow	Unclustered
Spartacus	F1
Spartacus24	Unclustered
Spartan117	Unclustered
Spartan300	B1
Sparticus	Unclustered
Sparx	Unclustered
Sparxx	Unclustered
Speck2x	Unclustered
Speckie	Unclustered
Speckle	Unclustered
Speckles	B1
Specks	C1
SpeckTop	Unclustered
Spectrum	Unclustered
Speed	Unclustered
SpeedyGonzales	Unclustered
Spejmaticks	Unclustered
Spercal	Unclustered
Sperk	Unclustered
Sphark	Unclustered
Spheric	Unclustered
Sphinx	Unclustered
Spike	Unclustered
Spike509	A3
SpikeBulldog	Unclustered
Spiner	Unclustered
Spiritus	Unclustered
Spite	A1
Splat	A10
SpookyMk	Unclustered
Spoon227	Unclustered
Spoonbill	F1
Spot	Unclustered
Spots	Unclustered
Spotty	Unclustered
Spring	Unclustered
SpringPoint	Unclustered
Sprinkle	Unclustered
Sprinklers	Unclustered
Sprinkles	Unclustered
Sprinklez	Unclustered
Spruce	Unclustered
Spud	C1
Spunk	Unclustered
Spunkie94	Unclustered
Spurcatrix	Unclustered
Spyder458	Unclustered
Spyro	Unclustered
Squag	Unclustered
Squid	B1
Squidney	A3
Squig	Unclustered
Squints	Unclustered
Squirrel	Unclustered
Squirt	Unclustered
Squirt12	B1
Squirt17	Unclustered
Squirtle	Unclustered
Squirty	F3
SquishE59	Unclustered
Squishy	Unclustered
SquishyE	Unclustered
SrSusan	Unclustered
SSMulta	Unclustered
Stacey	Unclustered
Stacky	Unclustered
Stanley	Unclustered
StanleyGrubber	Unclustered
StantonFam	Unclustered
Stantonidous	None
Star	None
Stark	E
Starkid	Unclustered
Starryhyles	Unclustered
Stathikisj	Unclustered
SteakSauce	Unclustered
Stealth	E
StealthRUs	Unclustered
Stella2214	Unclustered
Stencil	Unclustered
Stephanie	Unclustered
Stephen	A3
Stephig9	Unclustered
Stercus	Unclustered
Steve	Unclustered
Steve03	Unclustered
Steve27	B1
Stevebobs	Unclustered
Stewie	Unclustered
StewieG	Unclustered
Sth9309	Unclustered
Sthe	Unclustered
SthokoNV	Unclustered
Stick2JrJr	Unclustered
Stiggy86	Unclustered
Stinger	B4
Stinkybox	Unclustered
Stinson	Unclustered
Stitch	Unclustered
Stogey	Unclustered
Stokes13	Unclustered
Stoneous	Unclustered
Stonewall	Unclustered
StoPha2	Unclustered
Storm	Unclustered
Strainuous3	Unclustered
Straixir	Unclustered
Stratt33	Unclustered
Strawberry	Unclustered
Striker	Unclustered
StrongIslander	Unclustered
StrozzaTB	Unclustered
Struggle	Unclustered
StruggleBus	Unclustered
Stuart	Unclustered
Stubble	Unclustered
Studmuffin	Unclustered
Stuff	Unclustered
Stumpy	A2
Stumpy1	Unclustered
Stunt45	Unclustered
Stusha	Unclustered
Stuxnet	Unclustered
Suave	Unclustered
SubjectZero	Unclustered
Subrom	Unclustered
Sucette	Unclustered
SucetteDeLMort	Unclustered
Sucram	L2
Suffice	A4
Suffolk	B1
Sugar	Unclustered
SugarBear	Unclustered
Sugarloaf	Unclustered
Sugarplum	Unclustered
SugarPuff	Unclustered
Sukude	Unclustered
Sulley	K1
Sully	Unclustered
Sulski	Unclustered
SultanOfScree	Unclustered
Sumatra	Unclustered
Sumcarez	Unclustered
Summatime	Unclustered
Summer	Unclustered
SummersDay	Unclustered
Summit7	Unclustered
SUMO	Unclustered
Sumy	Unclustered
Sunflower	Unclustered
Sunflower4	Unclustered
SunHalo	Unclustered
Sunny	Unclustered
Sunnydelight	Unclustered
SunnyinPhilly	Unclustered
Sunnymoon	Unclustered
Sunshine	Unclustered
Sunspot	Unclustered
SunTzu	A1
SupaPhreak	Unclustered
SuperAwesome	A6
SuperBubble	Unclustered
SuperGrey	F1
Superman	Unclustered
SupremeSupreme	Unclustered
Suprette	Unclustered
Surivmon	Unclustered
Surya	U
Susan	Unclustered
Suthy	Unclustered
Suzie47	Unclustered
Swagger	Unclustered
Swaggington	Unclustered
Swamp	Unclustered
Swampert	Unclustered
SwampGhost	Unclustered
Swampy	Unclustered
Swarley	Unclustered
SWAT	Unclustered
Sweeney	Unclustered
SweetCaroline	Unclustered
SweetiePie	A2
SweetMocha	Unclustered
Sweets	Unclustered
Swesh	Unclustered
Swirley	A5
Swish	B1
SwishCheese	Unclustered
SwissCheese	Unclustered
Switzer	A1
Swoop	Unclustered
Sybil	Unclustered
Sydlosac	Unclustered
Sykes	Unclustered
Sylar	Unclustered
Symbah	Unclustered
Symi	Unclustered
SYNK	Unclustered
Syntax	Unclustered
T1Taga	Unclustered
TA17A	B2
Taboo	Unclustered
Tachi9	Unclustered
Taco	Unclustered
TacoCat	Unclustered
Tacolla	Unclustered
TaDaBa	None
Tadpole	Unclustered
Tadpole1	Unclustered
Taes	Unclustered
Taichun	Unclustered
Tailey	H1
Tailypo	Unclustered
Taino	Unclustered
Taj	F1
TallGrassMM	B1
Tallulah	Unclustered
Talon	Unclustered
Taloola	Unclustered
Taluliames	Unclustered
Tangled	Unclustered
Tania2	Unclustered
Tank22	Unclustered
Tantarobba	Unclustered
Taquito	K4
TaraDS	Unclustered
Taralyn	Unclustered
TarBall	Unclustered
Target	A1
Tarnat	Unclustered
TarsusIV	Unclustered
Tasha	Unclustered
Tashima	Unclustered
TaskForce	Unclustered
TasmaneiniDevi	Unclustered
Tasp14	A1
TaterTot	Unclustered
Tatum	G
Taurus	A3
Tausome	Unclustered
TayDrea	Unclustered
Taylor	Unclustered
TaylorComet	Unclustered
TaylorTower	Unclustered
TayRay	Unclustered
Taytay	Unclustered
Tazz	Unclustered
Tazzz	Unclustered
TBHunter1	Unclustered
TBHunter3	Unclustered
Tchaikovsky	Unclustered
Tcox12	Unclustered
TeaPeaK	Unclustered
Teardrop	C1
TeardropMSU	E
Tedd	Unclustered
Teddy	Unclustered
Teebjayl	Unclustered
Teemo	Unclustered
Teeny	Unclustered
TeenyTiny	Unclustered
TeetorTitor	Unclustered
Tekla	J
Temazcal	Unclustered
Temi	Unclustered
Tempie	Unclustered
Tenebario	Unclustered
TenOuttaTen	Unclustered
Tenzin1	Unclustered
Teri	Unclustered
Termin8or	Unclustered
Terminator	Unclustered
Terra	Unclustered
Terrance	None
TerranusJE	Unclustered
Terrasolum	Unclustered
Terrence	None
Tertomma	Unclustered
Teru1021	Unclustered
Teshome	Unclustered
Teslin	Unclustered
Tessa	Unclustered
Texage	Unclustered
Texas	Unclustered
Tezzeret	Unclustered
TFrancis	Unclustered
TGIPH	Unclustered
Thanatos	Unclustered
ThaniTOT	Unclustered
Thanksgivukkah	A4
Thayer	Unclustered
TheColePhage	Unclustered
TheCube14	Unclustered
Theia	A5
TheLittleOne	Unclustered
Thelonious	Unclustered
TheloniousMonk	A1
Themba02	Unclustered
TheO	C1
Theodore	Unclustered
TheRipper	B4
Theshyone	Unclustered
TheStranger	Unclustered
Theta	Unclustered
ThetaBob	Unclustered
TheVindicator	Unclustered
Thibault	J
Thing1	Unclustered
ThisIsIt	Unclustered
Thomas	Unclustered
Thor	A1
Thora	B1
Thotiana	Unclustered
ThreeOh3D2	B1
ThriftShop	Unclustered
Thuathua	C1
ThugWaffle	Unclustered
Thumbalina	Unclustered
Thunder	Unclustered
Thundercat	Unclustered
Thuthu	Unclustered
Tibbie	Unclustered
Tiberius	Unclustered
Tich1	Unclustered
Tico	Unclustered
Ticoyoso	Unclustered
Tiffany	A3
TiffTitus	Unclustered
Tiger	A5
TigerFriar	Unclustered
TigerLily	Unclustered
Tigerschark	Unclustered
TigerW	Unclustered
Tigger3pi	Unclustered
Tigger99	Unclustered
Tighe	Unclustered
TIIC	Unclustered
Tikkie	Unclustered
Tilikum	Unclustered
Till5	Unclustered
Tilly	Unclustered
TimCurry	A4
TimHoward	Unclustered
Timidus	Unclustered
Timmy	Unclustered
Timo	Unclustered
Timon	Unclustered
Timothy	Unclustered
TimP	Unclustered
Timshel	A7
Timtom	Unclustered
Tina	Unclustered
TinaFeyge	A4
TinaFrank	Unclustered
Tink	Unclustered
Tinkerbell	Unclustered
Tintin	Unclustered
Tintinade	Unclustered
Tiny	Unclustered
TinyC	None
TinyDancer	Unclustered
TinyKong	Unclustered
Tinysky2	Unclustered
TinyT	Unclustered
TinyTim	C1
TinyTitan	Unclustered
TinyTots	Unclustered
Tioga4	Unclustered
Tipsy	Unclustered
TireTrack	Unclustered
TiroTheta9	A4
Titan	Unclustered
Titanic	Unclustered
Titanium	Unclustered
TiterFighter	Unclustered
Tito	Unclustered
Titus	Unclustered
TizzleFlarp	None
TM4	K2
TMac	Unclustered
TNguyen7	A3
Toad	Unclustered
Tobago	Unclustered
ToBeKnown	Unclustered
Tobey	Unclustered
Tobias	Unclustered
Toby	Unclustered
TobyTerry	Unclustered
Tocayo	Unclustered
Todacoro	Unclustered
Todd	Unclustered
Todd2	Unclustered
Toitle	Unclustered
Tokipu	Unclustered
Tokyo	Unclustered
Tolkien	Unclustered
Tomahawk	Unclustered
Tomand	Unclustered
Tomatoes	Unclustered
Tommy	A1
TomTomJr	Unclustered
Tonenili	Unclustered
ToneTone	A6
Tonitrui	Unclustered
Tonky	Unclustered
TonyTina	Unclustered
Tooks	Unclustered
Toola	Unclustered
Tootsie	Unclustered
Tootsie14	Unclustered
TootsiePhay	Unclustered
Tootziepop	Unclustered
Topaz	Unclustered
TOPdog	Unclustered
TorinLord	Unclustered
Torque	Unclustered
Torrance3259	Unclustered
Torro	Unclustered
Tortellini	Unclustered
Tortoise16	C1
Tortuga	Unclustered
Tosin	Unclustered
TotesCute	Unclustered
Totfone	Unclustered
Toto	E
Toxic	Unclustered
Tpac	Unclustered
Tpap	A4
Tr33	Unclustered
Trademark	Unclustered
Trainorbn12	Unclustered
TrainTime	Unclustered
Tralfmadore	Unclustered
Tranice	Unclustered
Tranquility	Unclustered
Tranvogen	Unclustered
Trash	Unclustered
Trasmeen	Unclustered
Trastoly	Unclustered
Traveller	Unclustered
Travis	None
Tre	B1
Treadwell97	Unclustered
TrebleMaker	Unclustered
Treddle	A1
Tree	Unclustered
TreeBaby	Unclustered
Treebeard	Unclustered
Treehollow	Unclustered
TreeHugger	None
Treesa	Unclustered
Tremijas1	Unclustered
Tren	Unclustered
Tres	B2
Trex	Unclustered
Triangle	Unclustered
Triassic	Unclustered
TribalPhever	Unclustered
TribeChoice	Unclustered
Trickster	Unclustered
Tricky	Unclustered
Trident	Unclustered
Triforce	Unclustered
Trike	A10
Trikez	Unclustered
Trilla23	None
Trina	Unclustered
Trini	Unclustered
Trinity	Unclustered
Tripl3t	A1
Tripleovertime	Unclustered
Trippy	Unclustered
Tris	Unclustered
TritusRC	Unclustered
Trixie	A2
TRock	Unclustered
Trojan	Unclustered
Troll4	D1
Trooper	Unclustered
Trooper101	Unclustered
Tropics	Unclustered
Trotsky	Unclustered
Trouble	A1
Trouble13	Unclustered
Troublemaker	Unclustered
Troum	Unclustered
Troutissa	Unclustered
TruEd	Unclustered
TrufflaTrees	Unclustered
Truffula	Unclustered
Truman	Unclustered
Trypo	B1
TTimes2	Unclustered
Tucker	Unclustered
TuckHudg	Unclustered
Tuco	E
TuesdayTeaAt3	Unclustered
Tueur	Unclustered
Tulip	Unclustered
TupacRIP	Unclustered
TuPlaque	Unclustered
Tuppola	Unclustered
Turbid9	Unclustered
Turbido	A2
Turbo	Unclustered
Turby	Unclustered
Turj99	A1
TurkeyDay08	Unclustered
Turnpike	Unclustered
Turnup	H1
Turtle	Unclustered
Tvorc	B4
Twamp	Unclustered
Tweak	Unclustered
TweedleDee	Unclustered
Tweetbug	Unclustered
Tweeter	Unclustered
Tweety	F1
TwelfthPlague	Unclustered
Twilight	Unclustered
TwinA	Unclustered
TwinkeeToo	Unclustered
Twinkey	Unclustered
Twinkles	Unclustered
Twinnie	Unclustered
Twinx	Unclustered
TwistedApple	Unclustered
Twister	A10
TwistO	Unclustered
Twitch	Unclustered
Twix	Unclustered
Twixx	Unclustered
Twizzel	Unclustered
Twochainz	Unclustered
TwoFace	Unclustered
TwoLucky	Unclustered
Twopenny	Unclustered
Twort	Unclustered
Tyche	Unclustered
TygerBlood	A4
Tyke	C1
Tyndall	Unclustered
Typhoon	Unclustered
TyrannoMEGArex	Unclustered
Tyrannous	Unclustered
TyrionLanister	Unclustered
Tyrone	A2
Tyrus	Unclustered
U2	A1
Ubetchya	Unclustered
Uffda	A1
Uglyduckling	Unclustered
UHDchampion	Unclustered
Ukukhanya	Unclustered
Ukulele	E
Uline	Unclustered
Ulysses	Unclustered
UMadBro	Unclustered
UMAWPhabio	Unclustered
Umbra	Unclustered
UMWDaisy	Unclustered
UncleHowie	B1
UncleSam	Unclustered
UncleSi	Unclustered
Uncooperative	K2
Underdog	Unclustered
Underminer	Unclustered
UnionJack	A5
Uniqua	Unclustered
Unknownfriend	Unclustered
Unsequencer	None
Updawg	A2
UPIE	L1
Uprinter14	Unclustered
Urga	Unclustered
Urkel	None
Urmi3	Unclustered
Ursula	Unclustered
Usavi	Unclustered
Ususindagari	Unclustered
Vacant7	Unclustered
Vader	Unclustered
Valhalla	Unclustered
Validus	K1
Valinor	Unclustered
Valkyrie	Unclustered
Vallari	Unclustered
VancortXP	Unclustered
Vandal	Unclustered
VanHelsing	Unclustered
Vanilla	Unclustered
Varg	Unclustered
Vasunator	Unclustered
VasuNzinga	Unclustered
Vball11	Unclustered
Vega	Unclustered
Vega18	Unclustered
Vegeta	Unclustered
Veggie	Unclustered
Velveteen	F1
Venablu	Unclustered
Vendetta	Unclustered
Veneno	Unclustered
VeniVidiVici	Unclustered
Venkman	Unclustered
Ventus	Unclustered
Venus	A1
Venus1	Unclustered
Veracruz	A3
Verb	Unclustered
Vermond	Unclustered
Vernon	Unclustered
Veteran	Unclustered
Vetoed	Unclustered
Vfas	Unclustered
Vhyola	Unclustered
Via2013	Unclustered
Victor	Unclustered
Vikus	Unclustered
VillaNatalin	Unclustered
Villavisanis	Unclustered
Vincent	Unclustered
Vincenzo	B4
Vincint	Unclustered
Vinjamurium	Unclustered
Vinny	Unclustered
Vinylhead	Unclustered
Vinylwins	Unclustered
Viola	Unclustered
Violet	A1
Viralprincess	Unclustered
Virgil	Unclustered
Vironatron	Unclustered
Vista	B1
Vitali	Unclustered
Vitory	Unclustered
VivalaVida	Unclustered
Vivaldi	B1
Viviana	Unclustered
Vix	A3
Vixen	Unclustered
Vladimir	Unclustered
Vochelli	Unclustered
VohminGhazi	A6
Voldemite	Unclustered
Voldy	Unclustered
Volleyball527	Unclustered
Vonder	Unclustered
Vorax	Unclustered
Vorrps	Unclustered
Vortex	B1
Vortexer	Unclustered
Vrykolakas	Unclustered
Vulcan	Unclustered
WAC4	Unclustered
Wackplaque	Unclustered
Waddell13	Unclustered
WadeNo3	Unclustered
Wadriann	Unclustered
Waffle	Unclustered
Wagner	Unclustered
WakeNPhake	Unclustered
Waker2	Unclustered
WakeTech01	Unclustered
WakeTech02	Unclustered
Wakky	Unclustered
Waldo	Unclustered
Waldo123	Unclustered
Walker	Unclustered
WalkerTxRanger	Unclustered
Walla	Unclustered
WallabeeWay	Unclustered
Wallace	Unclustered
Wallhey	Unclustered
Wally	C1
Walt	Unclustered
Walter	Unclustered
WalterMcMickey	Unclustered
WalterWhite	Unclustered
Wana	A10
WANAjo25	Unclustered
Wanda	J
WandaP	Unclustered
Wander	A4
Warder	Unclustered
Warenger	Unclustered
Waronwar	Unclustered
Warrior	Unclustered
Warrior2014	Unclustered
Warthog	Unclustered
Wasp	Unclustered
Watchmen	Unclustered
Waterdiva	B1
WatussiXD	Unclustered
Wave	Unclustered
Waygie	Unclustered
WDonaldW	Unclustered
Weasel	Unclustered
Weasley	Unclustered
WebSlinger	Unclustered
Webster	Unclustered
Wednesday530	Unclustered
Wee	F1
Weedy	Unclustered
Weej	Unclustered
Weema	Unclustered
Weeman	Unclustered
Weezy	Unclustered
WeinerDog	Unclustered
Weirdo	Unclustered
Weiss13	R
WeiToGo	Unclustered
Wellnox	Unclustered
Wendy	Unclustered
WendyBird	Unclustered
Wendys	Unclustered
Wentao	Unclustered
Wesker	Unclustered
Wetill	Unclustered
WGPh	Unclustered
Whabigail7	A2
Whale	Unclustered
Whataguy	Unclustered
Wheat108	Unclustered
Wheeler	A1
Wheetthin	Unclustered
Whenindoubt	Unclustered
WhereisWaldo	Unclustered
Whim	Unclustered
Whirleybug	Unclustered
Whirlwind	L3
Whiskers	Unclustered
Whiteangel	A4
WhiteLightning	Unclustered
WhiteOnion	Unclustered
Whitetail	Unclustered
WhiteWhale	Unclustered
WhiteWizard	Unclustered
Whoops	Unclustered
Widget	A1
Wiggin	Unclustered
Wiggins	Unclustered
Wigglez	Unclustered
WigglyWorm	Unclustered
Wilber	Unclustered
Wilbur	A4
WildBill	Unclustered
Wildcat	V
Wildefire	Unclustered
WildPhat	Unclustered
Wile	A4
Wilie	Unclustered
Wilkins	A1
Will	Unclustered
Willez	E
Willis	C1
Wilmo	Unclustered
Wilota	K1
Wilson	Unclustered
Wilson2013	B4
Wimbledon	Unclustered
Wimpy	Unclustered
Winchester	Unclustered
Winky	L2
Winnie	Unclustered
Winston	Unclustered
Winter	Unclustered
Wintry	Unclustered
Winzig	Unclustered
Wish1715	Unclustered
WIVsmall	F1
WIVsmall1220	None
Wizard007	A4
WizKid	Unclustered
Wods	Unclustered
WolFang	Unclustered
Wolfgang	Unclustered
Wolfthorn	Unclustered
Wolverine	Unclustered
Wonder	A3
Wonderer	Unclustered
WonderFalls	Unclustered
WonderWoman77	Unclustered
Wonky	Unclustered
WoodShoe	Unclustered
Woody	Unclustered
Woof	Unclustered
Wookie	Unclustered
Wooldri	Singleton
Woosun	Unclustered
WootieJr	A5
Woozle13	A2
WorkStud14G	Unclustered
WorldEater	Unclustered
WreckingBall	None
WrobelPrize	Unclustered
Wuhan	Unclustered
Wunderlich	B1
Wuthering	Unclustered
WYdent	Unclustered
Wyran	Unclustered
Xalem13	Unclustered
Xander	Unclustered
Xavi	Unclustered
Xavier	B1
XavierOmicron	Unclustered
Xeba	Unclustered
Xela15	Unclustered
Xeno	N
Xenofonda	Unclustered
Xenon	Unclustered
Xerorex	Unclustered
Xerxes	N
XFactor	F1
Xiaopingtu	Unclustered
Ximenita	K3
xkcd	E
Xterminator	Unclustered
Xula167	Unclustered
Xylantius	Unclustered
Xylem	Unclustered
Xyloto	Unclustered
Xzanxzer	Unclustered
Yahalom	B3
Yahighness	A2
Yanis	Unclustered
Yank	Unclustered
Yardley91	Unclustered
Yash	Unclustered
Yashira	Unclustered
Yasir	Unclustered
Yatto	Unclustered
Yecey3	Unclustered
Yell	Unclustered
Yellow	Unclustered
Yemp	Unclustered
Yesac	Unclustered
Yeti	Unclustered
Yogibear	Unclustered
Yogurt	Unclustered
Yoko2480	Unclustered
Yolanda	Unclustered
Yollom1417	Unclustered
Yolo	A5
Yoncess	Unclustered
Yonose	Unclustered
YoonJu	Unclustered
Yoospirit	Unclustered
Yoshand	B1
YoshB	Unclustered
Yoshi	F2
Yossarian	Unclustered
YouGoGlencoco	B1
Youngblood	E
YoungGun	Unclustered
YoungOne	Unclustered
Yoyo	Unclustered
Ypsitucky	B1
Yseedy	Unclustered
YungJamal	O
Yunkel11	Unclustered
Yuyu12	Unclustered
Zaaboot	A2
Zaboo	Unclustered
ZachAttack	Unclustered
ZachCStarewich	Unclustered
ZacheriahCL1PU	Unclustered
ZacheryCLake	Unclustered
ZAG12	Unclustered
Zagman	Unclustered
Zags	Unclustered
Zaka	A6
Zakhe101	O
Zakhe102	Unclustered
Zama	Unclustered
Zamani	Unclustered
Zambuka	Unclustered
Zammy	Unclustered
Zamora	Unclustered
Zams	Unclustered
Zanasfish	Unclustered
Zaney	Unclustered
Zanos	Unclustered
Zapner	F2
Zappa	Unclustered
Zardona	Unclustered
Zashind	Unclustered
Zassy	Unclustered
Zazu	Unclustered
Zebulon3	Unclustered
Zed42	Unclustered
Zeeba	A1
Zeenon	C1
Zelda	B1
Zelezo	A1
Zemanar	B4
Zen222	Unclustered
Zena17	Unclustered
Zenon	R
Zeny	Unclustered
Zephyr	A1
Zeppelin	Unclustered
Zerg	Unclustered
Zerneshlia	Unclustered
Zero	Unclustered
Zerstoerer	A10
Zetzy	A3
Zeus	Unclustered
Zeus1	Unclustered
Zeuska	A1
Zeusy	Unclustered
Zhangus	Unclustered
ZheroDRT	None
Zieke	Unclustered
Zigg	K2
Zigzag	Unclustered
Zigzags	Unclustered
Zilerak	Unclustered
Zippy	Unclustered
Ziva	Unclustered
Ziynet	Unclustered
Zoboomaphoo	Unclustered
ZoeJ	K2
Zola	Unclustered
Zollars18	B3
Zombie	G
Zonia	B1
Zoolander	Unclustered
ZoomZoomZoom	Unclustered
Zoosk	Unclustered
Zorbinski	Unclustered
ZoSo	Unclustered
Zoziegirl	Unclustered
Zuko	Unclustered
Zuzu	Unclustered
ZygoTaiga	C1
